id	seq
ps_bridge1	CACTCCAATCACCAAATAACAACCATCTCATTCCTTTCATTTACCA
ps_bridge2	TCAATTTCACCACAAACCTCATTTCTAACTCACAACCTCCTACTTA
ps_bridge3	ACTAATCCTCTCAACACCAAATTACTTCACCTCCATACACACCTTC
ps_bridge4	AAATCTTCACCAAACCACTAAACCTTTCCTATACCACCTAACCTAA
ps_bridge5	ACACACATCAAACCTTTCCTCCATATCACATCCATCAACTTAACCT
ps_bridge6	TCATCCAAACTATCCTCTACACCTATATTCAACCTTCCTAACCACA
ps_bridge7	TTCAAATCACTCCACACCACTAAACTACCACACTTCCAAATCTTAT
ps_bridge8	TATTTCCTCACAATTCCACTCACACTCTATCATTACACTCTTCCAC
ps_bridge9	TTACTCTTCCAACCATCACATTTCTCCACAACACACACTACACCTC
ps_bridge10	CAATAAATTCCACTTCTTAACCACACCACATCTTCTCACTCCTACT
ps_bridge11	AAATTAAATCCACAACCTCTAACCACTCAATCCTCACCAAATTCAT
ps_bridge12	TCCACTTAAACCAACAACTCAATCTCACCAAACTTAATCACCAACA
ps_bridge13	AACCACCACTCATTAAATCCTTCCATCTACCACCTAAACTTCATCA
ps_bridge14	CCACAACATACACTAACAATCACTCCTTTACATCCTCCAATCACCA
ps_bridge15	CTACATTCCATCAAACTATTCAACCTCAACACCATCTTCTCCTTTC
ps_bridge16	TACCTTAACAAATCACACTATACCAACAACTCCACACTCCTCATAC
ps_bridge17	ACTCACATCTTCTTCCATCTCTTACACCTACAACTTCAACCTACAA
ps_bridge18	TCACTTTCTCTCACCACCTACACACTCTCATATCCACTAATTCACA
ps_bridge19	CTTCCAACCACTCCTCACAATAATACACCAAATCTTCTCAACTTTC
ps_bridge20	ACTATTTCTCCTATACTCAATCATCTCCATTCTCCACACTCCTTCT
ps_bridge21	CTCAACTCTTCTTCTTACTCTCCTCCTTTAATACACCTTCCTTCCA
ps_bridge22	CTTTAAATCTCTCTCACCTATCCTACTCATCCAACCACCTATCACC
ps_bridge23	CTTCAACATCTCATAACATCTCCAATCCAATCCACACAAACCACCA
ps_bridge24	CCTCACCATCCTTCTAAACATCCTTACATCTAACAATTCCACCTCA
ps_bridge25	TTTCATACTCTCTCCTCTCAATTACCTCCTTCAACAATCCATCCTA
ps_bridge26	ACCATAACAACTCACTCTCAATAACACCTCCTACTTCACTACCTAC
ps_bridge27	CATCATTTCCACACTAAACCTCTTACACTTCCAATTTCCACACTCT
ps_bridge28	AACTTTCTCTAACCAATACCTAAATTCCACACTTACCTACCACCTT
ps_bridge29	CAACCAAATCTTATTCAACACTCCTCCTTTCCACTTAATACCACAA
ps_bridge30	TCATTTCCACCTATCTCAACCTTCTCCTTCACTCCTCACACACAAC
ps_bridge31	CTACAACTCTTCTACCTCTCATTCCTCTAAACATCCACCATCAACC
ps_bridge32	ACAACCATCACCTCCTACCACATTCTTACCTACACTCTTCTATATA
ps_bridge33	CAACCTCACTTCCTCAACTAACCTTTACTCCTAAACAACTCTACAA
ps_bridge34	CCATAACTCACAACCAACCTAACAATATCACTCCACTTTCTTTCCT
ps_bridge35	ACTCCATACCTTACCAACTATACTCCACTTCACCAACATCCAATCT
ps_bridge36	CCACACAATCTCACCACCATCCAATACATCATTCCTATCTAACTCT
ps_bridge37	AATCCTTACTCATACATTCACCACTCAAACACCAACCATATCACTT
ps_bridge38	CTCATTCACATTACACTCAACCACTAAATACCACCACTCATCATCC
ps_bridge39	TACATCCACCTCACAAACACTTTCCACTCCTCACACTACTAACTAC
ps_bridge40	CTTTCTCACTCACTCCTAATTCAACTCACTTCCTACAACAATACCT
ps_bridge41	TACATCATCCACAACTATCCTCCACAATCTTACTTCCTCCTTACAA
ps_bridge42	ACCTCTTCCTACACCATTCACCTTATCCTAACATCTAACCATATCA
ps_bridge43	TCCACTTCTTCACCATCACACATTTCTCCTCCATATCTTTACAACC
ps_bridge44	ACCTCTCACTTCACCTTATATAATACATCCACACATCCTTTCACAC
ps_bridge45	CAATTCCAAACCACATTCAATCTCTTTACCACACAAACAACCTAAC
ps_bridge46	TTTCAAACAACCAAACCATCCAACTCACCTTATCTCATTTCTCACC
ps_bridge47	TCTAACACCAACTCACACACCTATACCAACTACCTCATATCATTCC
ps_bridge48	ACACCACACTCTTCCTAACCAACAACATAATACTACCATCAACACT
ps_bridge49	TTACTTTCCTCCAACACTAATCTATTCCAATTCACAACCACCATCA
ps_bridge50	TACACATCACATTCACCAACACAATCACAAACAACACACTTACCTT
ps_bridge51	ACTTCACTACTTCATCCATCTCTACTTCAACTCCACCTTTCTCTAT
ps_bridge52	CTTTCAAATACCACCTACAATCCTACCACAATCTCCAATCCACTAC
ps_bridge53	ATCCTACTCACAACCTTTCAAACCAACACAACTATATCACCTCATT
ps_bridge54	CACCTCCTACACTCTATTCCTCCTCAACCAACCAATTCACAACTAA
ps_bridge55	CCTCCTTATCAATTCATACTCCACCACATTCAAACACACTCCATCC
ps_bridge56	TCATCCACACACACTATACCATTTAACCTCAACCATATCACCAATT
ps_bridge57	CTAATCCAACCTCACCAATCTCACTTTCCTTCTCCATACACCTCTA
ps_bridge58	TCTCTTATTATCCATCACTTCACCACAATTTCACCATCTCCTACTC
ps_bridge59	ACATAACAACCACAACTCACACTCTCACAACCATCCATCAATAATA
ps_bridge60	AAACTCCTATTCAAACAATTCCACCTCATCTCTTATCCACCACTCA
ps_bridge61	TTTACTCTCACCTCAATACACCATCACTTCCTATACTCACCACTCA
ps_bridge62	TCCTAAACACACAAACATTACTTTCTTACCACTCTAAACCACCACA
ps_bridge63	CCACTCTTACCTACACCAACATTTAATTCACAACTCAACCAATCTT
ps_bridge64	ACCTCACTCACTTTCACCTCACTCTACAACTATTACTCCATTCATT
ps_bridge65	CACCTTCAACCTACCACAAACTATTTCCTACCACTCATACCACTAA
ps_bridge66	CTTCCATCATTCAACCAAACTCCTAACCTAAACTCACCAACCTACC
ps_bridge67	CTCTCCAACTTTAACCTAACAACAATCACTACTTCCACACCAATCA
ps_bridge68	AACTCACAACAAACAACTCTCACTCTATCAACACTACCTCACACCT
ps_bridge69	CTCTTCATACCATCTATCAAACTCCTCCAACCAACACACTACCTTC
ps_bridge70	CTCCTCCATCTTCTCTCCATCCTCTCCTCTTACAACTTCCAAACTC
ps_bridge71	CCATCCATCCTTTCTCATTCCAACACTCCATCCAACTATTTATCTA
ps_bridge72	TAATTTCCTCAATCTCCAACCACATCATTACACACATCCTCTTCTT
ps_bridge73	TCCACATCCACCAAACCTATCACACATTTCTTCAACCATCTAACCT
ps_bridge74	CCACCATTTCCTCTACAACCTAACATACTTTCTAACCACACCACCA
ps_bridge75	ACCACAATTCACCTTCTCTACCATTACTCTCCACTAATTTACCAAA
ps_bridge76	TTCTTTAAATACCACTTACCAAACAACCTCTCACAACTAACCAACC
ps_bridge77	ACACTTTCTCTAACTTATATACACCTAACCTCCATCTCTCACCACC
ps_bridge78	ACACAAATTACCACATTCCACACTCACTTACACATACTACTCTACA
ps_bridge79	TCCACTCAACATCCTTTACCATTCTTCCTCAAACAAATCACACCAT
ps_bridge80	CCAATACTCCTCTTCATTCCTCTACACCTTAACTAACCTTCATTCC
ps_bridge81	CTCTCCACACCTATCTCTTCAAATTTCCTAAACCAATTCCATCTCT
ps_bridge82	TACCACTTCAATAACCTACACATATCCTTCAATCCACACATTACCA
ps_bridge83	TAAACCACCTTCTCTCACTTTCACCTCTTTATCTACTCTCTTACCT
ps_bridge84	TATCCAACTAACCACCTACCATCACTTAACATTTCATACCACTCTC
ps_bridge85	ACTCATCCTCAATCTCCTCTTCTCCTCTCCATAACTACTCTCAACA
ps_bridge86	ACTTCATACTCCTATACAATAACATCCATTCTCCAACCACCTCACC
ps_bridge87	CTCATACCTTCCAACCTTACTCTCATAACTACAATCACCTCTCCTT
ps_bridge88	TATTCACCATCACCTTAAATCTCACCAATTCCAAACCAACAATCTT
ps_bridge89	TCTTCACCACACTCATCTACACTTTCTCTCCATACTCTATCCAATT
ps_bridge90	ACAATTCTACCTCTTTCAACTCTCTTCTCCTCTACCATCACCAACA
ps_bridge91	TTCATTCCATCACTCCAACACCATTTATCCAACACTTATCCTTTCA
ps_bridge92	ATCACCTTCCAATCAACCAACCTCAAACTATCTTTCTCCTCATTAT
ps_bridge93	TCCTACACTCTTCCTCACTCAAACAATTAACTTCCAATCAACCTCT
ps_bridge94	CTCACCAAACCTATTCCAAATCTTCATCCACTACACATTCTCCATT
ps_bridge95	TCACATCCAAACCTTACATCCTCCTCACTTTACCAATTCTACCACA
ps_bridge96	CCTCCTTCCTACTTATTCTACCACCTCACAACCATAACCATTACTT
ps_bridge97	AACCTCCAACACTTTCTCTCCAATCTTCCACACCATACCACTTACA
ps_bridge98	TCCATCCATAACCTATCTCAACTCTCCTATCCTCCAACTCATCTTA
ps_bridge99	CCTCCACAACAATACCTCCTTTCAAATTACCAACCTCACACTATTT
ps_bridge100	CACCTAAACTTCCTCTTCACATCAACACTTCCTACATCCATCATTA
ps_bridge101	TAATACCAACACTACCATCACACCAATTACTATCAACTCACCTACC
ps_bridge102	TTCCATCTTAACTCACTTTCACTCAACTCAACAACACAAATCAACA
ps_bridge103	ATCAAATCCTACTCATATACTCTACTCTACACTTCTCCAACCACCA
ps_bridge104	CAACTTCCACATAACAACCTCAACACTCTCCTACATTTCAACCTAT
ps_bridge105	ACCACCATCCTTCAATACCACACTATCTAAATCCACACCTTCTTCT
ps_bridge106	ATCACACATTATCACCTCCAATCCATCCAAACTCTCAACTTCTTAT
ps_bridge107	CCTAAATCATTAACCTCTCAACACTTCAATCACACACACTTTCCAC
ps_bridge108	ACCTCATCTACAACTTTCTTTCACCTCCATTCATACCACTACATCT
ps_bridge109	ACTTAATCCAATTCCACCAACCTTTAACTCCATCATCAACCTACTC
ps_bridge110	ACATTCTTCCTCACCTATCCTCCTCAAACTACCTCCTACTAATTTC
ps_bridge111	TACCACACCAACAACCTCAAATTCACTACCACTATTTCCATATCCA
ps_bridge112	CCTCTTTCTCTACTTTCTACCTAAACCACAAACTCCACAAACAACC
ps_bridge113	AATCCACTAAACACCTAACTCCATCTCCACATACTACCAATCCAAC
ps_bridge114	ACATCATTCCATTAACACACTCCTTCAACTCACTCCTCTTAATTCT
ps_bridge115	ATTCCAACCTCCAATATTAACCTACACTTTCATTCCTCTTACACCT
ps_bridge116	CCAACTCACACAAATCCATCTTTCTATCCAAACAACAATCCTAACC
ps_bridge117	CTTCCTCTCTACTCTCACTACCACCTACACTATACACAACATACCT
ps_bridge118	TACACAACTCACTACACATCTTTCCAAACATCTCACCTTTCTAACA
ps_bridge119	TTCACTCCAACTTAACAACCACAATACTCTTCTCAATTCTCTTCCT
ps_bridge120	AAACATACTCCATCCACTTACCTTCCTACCATCTAACCAATACACT
ps_bridge121	CTCCTCTTATCTCAACACCTCAACTAAACCACATTCCAACTCAACT
ps_bridge122	TTTACTTACATCTTACCTACCTCCTCTCCATCCAACATCAAACCTT
ps_bridge123	TTCCATATTCATCACCTACAAACCATCCATTACTCACACACAAACC
ps_bridge124	TCAACTTCATCACCAATTTACACTCTCACACAAATCCAATTCTCCT
ps_bridge125	TTATCTCTTCCATCTTACCATCACTCAACCAAACTCCACTCCATTC
ps_bridge126	TCTCCAATCACACCTAACTACAACACTTAACCAACCTATCTTCATT
ps_bridge127	CCTCTCCACTCCTTACTTAACCACTTTACAACTTCCAAACTTCCTT
ps_bridge128	CCAATATCCAACAACCATTCAATCTATCTAACCAACTTCCTCCAAC
ps_bridge129	TCACACTCCACACCATATCTCCAATAATCCATCAATCCACACCATA
ps_bridge130	AACATCTACCACCAAACTCATCCACAATCCATTCATTCATTACTCT
ps_bridge131	TCACTACATCCATAAATCACATACACCTACCTTCCTCCTATATCCA
ps_bridge132	ATCCTCAAACTCACTATTCCTTTCCTCCTTCACTACACACCATATT
ps_bridge133	AATCATTTCTTTCCACAATATTCACCACAATACCAATCTCACACCT
ps_bridge134	TCATCTACCTAATCTCCTTCTCATCAATCATAACTCACTTCCTCCA
ps_bridge135	TCTCACACACCTTATCTTACTACCACCTTACTTATTCCACCACAAA
ps_bridge136	CATAACCATTACTCCATACCTTCCACTCCTATTCCACACCAATAAC
ps_bridge137	ATCTTTACACCAACAACAACCACTACTCCACAACAAATCAAACTTA
ps_bridge138	CATTTCATCCACTATTCTCATCCACCTCCAAACATTCCTCACCAAA
ps_bridge139	CAATCCAATCACCTCACACATTCCTCCACTACATATTCCTACTAAC
ps_bridge140	TCTACCTCTTCATCCTCTCCAACTATCCAACTCATATCTAACCATC
ps_bridge141	CCTTCCTTACCAACAAACTAACACTATCACTTCCACTTCACCTCTC
ps_bridge142	CAACCTCTTACTTAACTTCAACTCAACCTCTCCAACAACTCTTACT
ps_bridge143	ATCAACACCTCTTCCAACACATCCTTATACTCCTCACCTACATTCC
ps_bridge144	TCCACAAACTACTTACCTTCTTAACCTCTTCCTACAATTCCACACC
ps_bridge145	TCACTCTCACTCAAACTCTCATACTAACAAACACATCCATACCACA
ps_bridge146	TCCTCAATTTCCACCTTTACCTCTTACCTCCAAACTTCTCACTACT
ps_bridge147	ACCACACAACACTAACACACAACATACATTTCACATTCAATCTCTC
ps_bridge148	CAATTCCACCTTAATTACTTTCACTCCATTCAACTCCACTCCACTA
ps_bridge149	CACCTTTCACTCTTTCACTTCCTTCCACTCCAACACATTCCTTCAA
ps_bridge150	CATCTCTCCACACATCTCCAAATACTACCATCCTCACCATAATCAT
ps_bridge151	AATACCATCATCAACACACTATATACTCTCTCCACCTTCATCCTCT
ps_bridge152	TTCACATCTCCTTTCTTCTTTCTTTCCTCTCAAACTCCTTCAACTC
ps_bridge153	TCCACACCTAACCTTTATAATTCCTACCATCTCTCTATCTCCACCA
ps_bridge154	CCAAATCCTACCATACCACCTATTCCACCTCATTATATCATCCTCT
ps_bridge155	CACCTATCCATCCATCATCAACCTACTCACCATCCTAATCAAACCT
ps_bridge156	ACTTACATTCCTCTATTCATACACCTTACCTACCACTACCACCAAC
ps_bridge157	TCTCTTCATCCAACCACCATAATTTCTACCACAACACTCCTTAACT
ps_bridge158	CCTCCACCAATTACACACTCTCTCCTCTACCTTATTACATCATACT
ps_bridge159	TCATACACACCAACATACCACTCATCTCTACATTCTCTCCTACACC
ps_bridge160	CCTACCACACACATCACACACACTCCATAACACAATTACATAACAT
ps_bridge161	ATATCTTCATCTCCATCATCACACCTATTCACTCACTTTCCAATCC
ps_bridge162	CTATCCACACTCACTCCTCTCATCAACTACTTTCCTCACAATTCTC
ps_bridge163	AACTAACCAAACAACAAACTCTCATTCTTCCACTTACTCCTCCTCT
ps_bridge164	CAACTTTCTCCTCACTCCACCAAACCTACACATTACTTATTCACAC
ps_bridge165	CCACACCTTCCAACCTCCACTATAACCATTTAATTCTTTAATCACC
ps_bridge166	CCAACATCTCACAATCATTCCTCCACCATCTATTCTTATCCAACTT
ps_bridge167	TCCACACCAACATTCACAATCCATTATCACCTTCAATATACTCCAA
ps_bridge168	ACAATCTTCACTACCACCACTAACATCTCAACTCCAATCTCATCAT
ps_bridge169	ACTTCTCACATTTACCATCACCATCCATATCCACTTCCATTCCATC
ps_bridge170	ATTTCCTCCATTTACAAATCCAACCTCCTCCTATCCTTTCCTACAC
ps_bridge171	CCATCATCCAATCTATCATAACCACCTACTTTCCATCTCCAAACAA
ps_bridge172	CCACACTATATCAACATTCTTCCACATTCCTCTCCTCCTACTCATA
ps_bridge173	AACTTCCTCTACCACTAACACATCACTTCCTCATCCATCCACTATT
ps_bridge174	TACTCCACAATCCTTATTCACTCACTCATTTCAACCTTCATCCACT
ps_bridge175	TCCATCTCTTATCCACTTCATCCTTCAACCTACTCCTCTCTATCAT
ps_bridge176	TTATTCCATACCAAACCTCATCACATACATCCACACACCAACTTCA
ps_bridge177	TTCATTCAACCTCCTTCTCCTCATCCAACTCTAATTTACACTCCTA
ps_bridge178	CCATAATCTCTTCCACTATCCATATCAACTCCAACCACCTAATACC
ps_bridge179	ACATCCACCTACCTCTACATCCAATTCTTCATCTCTTACCATCAAC
ps_bridge180	TCTTCAATACATAACCTCCTTTAACCATCCACAAACCATCCTCCAT
ps_bridge181	TCCACACCAACATCTAACCTCACCTTCATCATCTCTCTAAATTTAC
ps_bridge182	TTTCATCTTACCTTACATCACATTCACTTATCCACATTCCACTCCT
ps_bridge183	ACACATTTATCAACTCCTTATCAACACTTCTCCATTCTCCACAACC
ps_bridge184	ACAATTCTACTACACCTAAACCTAACACATCCTACACAACCAACAC
ps_bridge185	ATCTCCACCACCAATAACTACCTACATTACATCTATCATCTCTCCA
ps_bridge186	ATCAACCTCACTTCTCCTACATCCTTCACACCTTCAATCAATTCAA
ps_bridge187	CCACCTTTACATCTAATTCAACTTACCACTCACCACACTTTATCCT
ps_bridge188	TCCTCCACCATTCACACACTCAAATCTTCCATTTATACATTCTACA
ps_bridge189	AACAACCATCAACACACTTATCACCTCCTATAACTCCTTCCTCAAA
ps_bridge190	ACCTCCACTTAATCTTACACACCAACTCTCTTACATTCTCTTCTCA
ps_bridge191	CTCTCTATCACAACCACTTACCTCAATTCCTCTCTTCTCTAACCTC
ps_bridge192	TCCTTATCATTCCTCTCCACACTCAAATCCTCACTATCCAACACCA
ps_bridge193	TCTCCTTCCTATCACACACTTCTCACCATATTTCAATCATCACCAT
ps_bridge194	TTCAACATTCACTACACTTCCACCTCACTAACATACATTCAACCAC
ps_bridge195	ATTCACCAATCCTTCCATCACTCATCAACCATCTATTCTATCCACC
ps_bridge196	CCTCCTCTAATATACCTTTCTCTATCACACCTCCTTATACCTCACC
ps_bridge197	CACATCATTCACTCCTTTCCACCTCCAATAACACAAATCACCAATT
ps_bridge198	CATTCACTCCAACCAACAAATATACACACTACCTTACATCCTCCTA
ps_bridge199	ACACAACCAATTACTTACAACATTTCACTCAACACTTCCACCACAA
ps_bridge200	CTCCACCATCTAATCTTATTCATTCTTCCTACTTTCTCCACACCTT
ps_bridge201	TTCTTCAACTCCACATTTCCTCCAATCAACCTCACAACCAATCATA
ps_bridge202	TTCACAATCCATAAACCTTCTACCTTCTACACCACCAACATTCATT
ps_bridge203	ACTCCTTTATCAATCAACTCAAACACTCTTTCAACCACATCCTACA
ps_bridge204	CCTTCTATTTCTCAACTTCCACACACCTAATCCACACCAAACAATT
ps_bridge205	TCACTACATACATACCATAAACCACACTACTTCTCCACACTTCCAC
ps_bridge206	ACCACTCACACTTTCATCAACCACAATAACACTTCTTTCTCAACAT
ps_bridge207	TCCTACACTACACTCCAATACTTACTTCCAATTCCTTCCTTCTACA
ps_bridge208	CCAACTTCCAATTCCTCTTACTTCCTCCTCTCCTCCTACACTCCTC
ps_bridge209	ACACCTCCTCAACCTAACCTTCTTTCCTCTCCATATATACACTTAA
ps_bridge210	CCAAACACCATCCTTCAACATTTCAACATTCATCTCTCCATACAAA
ps_bridge211	CCACTTCCATACCAATCAATCCTACCATACACCTTCTTTCTCATCC
ps_bridge212	CAAATCACCAAACTCCTACACCACACCATTAATCTTCACACATAAT
ps_bridge213	AAACACCTCATACATAAATCACCTATCCACCTCAACCATTCCTCTT
ps_bridge214	TCATCTTCACCATCATTCTCTTACAATTTCCACACTCCTAATCCAT
ps_bridge215	TCCTTTCCAACACCTCAATAACATTTAACACCAATTCCTACTACCT
ps_bridge216	AACACACCACTCAAACTCTCACTAATCTCCTCTCCAAACAAATTCT
ps_bridge217	ATATTCAAATCCTCCTCCATCATCTCATCAAACATCACTCTCCATT
ps_bridge218	CCTCCTCCTTTATCCTCATCATACTCTCCTCACACATCATACTTTC
ps_bridge219	ATCACCATCACTTCCATTTACTCTCACACTCCATTACTACCTCAAT
ps_bridge220	AACTCCTCTCACTCCACCATATTTACACCATTCACCTAAATCAATC
ps_bridge221	AAACCAACCTCCTCAACATCATATCCACACTATACCTAACTTACAC
ps_bridge222	ACATCCATTTACCTTTCTCACTCTCATCTCATCCAAATTCATCTCT
ps_bridge223	ACTCACCTACAACCACTTATACAAACAACATTCTTCTCCTCCATAA
ps_bridge224	TCTCCTCTACACACACTTCACTCATTAACCTTCCATTTCTTCCATA
ps_bridge225	ACAACATCCTACATCTCCAACAAACAATATTATTCCACCACCACAC
ps_bridge226	CTATCCATAACTCCAAACTTCTCCATCCTCTTCCAACACTCTCACT
ps_bridge227	TTACCAATCATTTACCTTCACACAACCAATCCAACCTATTCTCCTT
ps_bridge228	ATTCTTATCATCCTTCCAACCATCTCCACATCATCCTTTCCATCAA
ps_bridge229	ACACAACCTACTACTCACCATTACACATACTCACAACATAACCAAA
ps_bridge230	ACCTCCTTTCTCACCATCCACTTAAACCTTCCACTATCCTCATTTA
ps_bridge231	CTTACTAATCACTCCAACACTTCATTCATCCAACACCTCTACCATT
ps_bridge232	AAACAAATCCATCCTCACATCCACACATAAACCAACACATCCTTTA
ps_bridge233	AAATTCACTTCCTCCACACTTCTTACAACTCTTAACCACAACCACT
ps_bridge234	TCATCAACCTTCCTTTCTTTCCAATCCAAATTAAACCTCCACAATT
ps_bridge235	TCCAACCTACAACATCACATCCATCTCCATACCAAACCTCCACCAT
ps_bridge236	ATTACCTCTTCACAAACACTCACTACAATCCTTTCTCCTCTTCCTA
ps_bridge237	TCACAACTAAACTCAACACTCCATCTCCTACATATCCTTATCCTCC
ps_bridge238	CCTAATCCAAACCACTCTCCTCAATAATTCCACTACCATCCTTCAA
ps_bridge239	CACACATAACCTTAATACACCTTCTTTCACTCTACCATCCACACCT
ps_bridge240	CCACATTCATAACTTCTCTCTCCTAACCAAACTCCACACTAAACCA
ps_bridge241	ACCTAACAATCAACAACTTCACACCAACCTATCACTCCATAACATA
ps_bridge242	CTCTCACTTCCTACACCATCACTTAACACCACTCAATCTCTACTCA
ps_bridge243	TCACCTACCTCTCTCTCCACTTATATCAAACATTCCAACACAACTC
ps_bridge244	CCACCTATTCTTATCCAATCTACCACCTAACAACTCCTCTTTCAAA
ps_bridge245	TCCTATCCAACTCATACTATAACCAATACCACCTCTCACATCTCCT
ps_bridge246	CACCAAACAACTCCTTCCATCAACCAAACAATCTCACTAAACTTAA
ps_bridge247	CTCTCTCTATATCCACTAACCTCTTCTCTCCACCAATCTTCACCTT
ps_bridge248	ATTACACCTTCTTCCACTACATTACACCAACCTATCCACTCTCTAA
ps_bridge249	TCCTCCTCTCCAACAACTAATCAAACACCTCTCTTTAACCACTACA
ps_bridge250	ACAACCTTCATCTTCCACCACATTCTCAAACACCTACATTACCTTA
ps_bridge251	TATACACCTCTTTAACCACCTACCACATCAATCCTCTCTCCATACA
ps_bridge252	TCCTCACCACAACTCACTAATTAACCAACAATTTCTTCCACACCTC
ps_bridge253	TCAATCCTCCTAACCTAACTTCTTAAACCTCTCACTCACTCCTTAA
ps_bridge254	ACAACTCCTCACTACCTTATTAACATCCTTTCCTACCACATCACTA
ps_bridge255	CCTTTCCTTCTCTTCCTTACCATCTCTCATCCTACCTTCATACAAA
ps_bridge256	ACAACCTTCTCTTCTTCCATACCATATATCCATTCCACACTTTCTT
ps_bridge257	TCCAACTCCAAACCAATTCTTATATCCTTTCCACCACAACATTACA
ps_bridge258	CTACACCTATCACCTTAAATCACCTTACACCTACAAATCTCCTCCA
ps_bridge259	TCACACCATTCTCTCTCATCTCTACATTCCTCTTACCTCACACTAA
ps_bridge260	ACTACTCTCCTCCTCTCTTCTTCCTCTTACCATCTCACTCATATCC
ps_bridge261	TACTCACTCCTACAACCACTCATCATCATATTCAACACCAAACTCA
ps_bridge262	CAACTCTTCCACCTAACCTTAACTTCTTCACACTTAATTCCTCCAT
ps_bridge263	TAATTATCACCAATTTACCAATCCTTCATCCTCTCCAACACACACA
ps_bridge264	ATCCACCTTTCATTCCTCATTTCACACCATCTTACTCCTTACAACA
ps_bridge265	CCACACTCTACACCAATTCCATCAATTCCTCTTAAATCACCATCTT
ps_bridge266	CCTAATCTTTCTAATTCACACACACTCACCACCATTCTCTACCAAA
ps_bridge267	ACCTCTCAACATCACCTCCTTTCACACTTTAACCTATTCTTATCAT
ps_bridge268	TTCTTTATCCACTCCTCCACTATTACCACATCTTTCCTCTTCCATA
ps_bridge269	TATCTTCACTTACCAACTCTCATCTCCTCACCATCATTCATTCCAA
ps_bridge270	CTCTCCACAAACCACTAACCTCCATACATTTCCTATCCTCCTTATA
ps_bridge271	CTCAACCTTTCCATTCAATTCACTTCCTTCCATTCCATTCTACACC
ps_bridge272	CTATAATCACCTTTCTTCATCCACTCCTTTCCTTAAACCAAACCAC
ps_bridge273	TAATCATCCTCACAACACAATACCTTCTCCTCAACTACCAAATCTT
ps_bridge274	ACATAACACCTAAACCAATTCCAACCACTCCACTTCTAAACAACAA
ps_bridge275	CAACTCCACTTTATTCCAACCTCCTTCCTTACTCCACTAACATTCT
ps_bridge276	ACAAATCATTCTCACCAATCTTCACCTTAATATCCACTCCACTTCT
ps_bridge277	ATTCCTTTATCACAACACCACAAACTTACTAACCTCAACACACATC
ps_bridge278	CCTACCTCAACAAATTCCTACCTATCTACCATCCTCAAATTTCCAA
ps_bridge279	CCTCACATAACATCTCATCTAACCTTTCCACACTCTCCTCACCAAT
ps_bridge280	ATTCCTCTCCTTTCTCTATCCTATACCTCCACTTCATCTTTCATCT
ps_bridge281	ACATATCTCTTCATCCATCACCAACCTCATCATATCAATACCACCT
ps_bridge282	CACTTCACATCTTCAACCAACCAACATACTCCATACAAATTTCCAT
ps_bridge283	CTTCAACCATCCTCACACAACTATCCAACACATACCAACAATTAAA
ps_bridge284	CTCCATTCCTTACTTCAACTTCACCTCCTAACATCACTCATCACTC
ps_bridge285	TCATCTTATTCACAAACTCCACACCATTTATCACACTCACACACCT
ps_bridge286	TTACATCAATCATACACCTCACACTCTCACACTACACCAATACATT
ps_bridge287	TCACCTATCATCATTCTCCATACACTAACCACCTTCTTCCATTACA
ps_bridge288	AACCACTCCATCTTTCACTTTACTACTCTATACCACTCATCATCCA
ps_bridge289	TCCTCATCTATCAACTCCATCACAACCTTCTCACATTCATAACCAC
ps_bridge290	TCTCTTACTTATCCTTCCTCTCTTCCACTACTACCTCCACAAATTC
ps_bridge291	ACACTCACTTATACTCTTCAACACATCATTATTCCACCATTCCACA
ps_bridge292	ATCCACATTACACCACTCTTCCTCTTTACAATACAACCAACATTCT
ps_bridge293	CTTCACCATCCACATCACACCAACTTATTCTCCACTACACTTACTA
ps_bridge294	TCACCACACATCAATCTCTCCTAAACACATTACTCACTCTCCATCC
ps_bridge295	TCTTCATTCTCACCTCCAATAACTCCTTTCCACATTACCAATACCT
ps_bridge296	ATCTTCCTCACTCCTTCAATTATACTCCTATTACCACTCCTACCAT
ps_bridge297	TTCAACACCATCTACCATACACATTCTACTCTCACTTAACACAACT
ps_bridge298	TCTCCACTCTATTCTCAACCAAACATTCATAAACAACTCCTACCTC
ps_bridge299	CTTCTACCTTCTTTACCTCAAACTAAACACATCTCTCTCCTACCAC
ps_bridge300	CCATTCCACACACCTTCCTACTTCCTATTTCTACACAAACTCACCA
ps_bridge301	TTCCAACCTTACCTTCCACCATTAATTAACTCCAAACACTTCCTTC
ps_bridge302	CCTCCATCTTCATTCTTTCTCTCTCTTCTTCCACCTCTCATCATCT
ps_bridge303	CCATATCATCTCCACTAATCTCTAAACTACCACCACCATACCACTA
ps_bridge304	CACACATCACATACAACCTCATATTCCTTCCTCACCACTCTCAATC
ps_bridge305	TACTCCTCCTACTACTATCCAACAACTAAATCATTCACCACACCAA
ps_bridge306	CCACAAATTATCTTTCACACCTCCATTCTTCCATACCTATCACCAT
ps_bridge307	ATTTCTTCATTTCCATCTCTTAACACTCACCATTCCTTTCCACAAA
ps_bridge308	CTCACCTACAACCTACCAAACACTCCACTAATTTACCTCTCTCTTC
ps_bridge309	ACACCACATTCCTTACTAACATTCTATAACCACCTCTCAACCATTT
ps_bridge310	ATCCTACAATCTATCCACACCTCACTAACCATACTCCTCTTCTTCT
ps_bridge311	ACACACTAAATTCTAACCACCTTCCAACCATTTACCTTATTCCTCT
ps_bridge312	TCACAAACACCATACAATCACTTATCATTCCTCTCCATTACACTCA
ps_bridge313	CCTCTAAACTTCCTACCTTTCTAACTCACATTCTCACATACAACCA
ps_bridge314	TATCAAACCAACCACACACACATTTAATTACCATCCTCCTACTCAA
ps_bridge315	TTTCTCCTCTACCACATCTCTTATCCACTTTCCTTCCACTTAACAA
ps_bridge316	CTCACACCTCTCTTCATTCACCATTCACAATTAATCTACCTCCAAA
ps_bridge317	CAACACATCACTTTCCATCACTCCACCTATTTATCTACCACACACT
ps_bridge318	CCACTCCTCACAATCTTCCTCACAATCAAATCTCTTTCCTCTCTCT
ps_bridge319	CTCAAATCACCACCTCATCTTCCATTATTATTCTACTCTCCTCACC
ps_bridge320	CTCATTCAAATCTACTCCTCTACACATCCTACAACTTTCCTTCCAT
ps_bridge321	AAACCATAACTTCAACATCTTTCAACCTCCAAATCTCTCTCAACAC
ps_bridge322	TCAATACTTCCTAATCCTCACAACCTTTAATTCACACTCCATCACT
ps_bridge323	CCACCTCATCTACACACAATATTTAAACCAATCCACACATCTCCAC
ps_bridge324	ACACCACCATTCTACTTCCACTTACCACTATCTTAACTCATTAACC
ps_bridge325	AACATCAACTAATTTCCTACCTCCTTTCACAATCCTCTACCAACAA
ps_bridge326	AACTCCTCAATACAATCACCATTCCTCTAACTCCATCTTCTAACCT
ps_bridge327	CACCACTTAATCCTAAACCATATTTCCTACATCACTCCTCCTCAAC
ps_bridge328	ATCCACAATCACTCATCCATCCTTTACAAATCCTTTCACATCCAAA
ps_bridge329	CAACTACCTATCCTACTCCTCAATACATACATCCACCAACTTCCTC
ps_bridge330	TCCAAACTCCTACAAACATTCCTCATCACAAATTCCATACTCCTCT
ps_bridge331	ACACATCCTCCAACTCACAACCATTACCAACTTCTTTCCACCACTA
ps_bridge332	CTCACCTCACTAACCTCAAACCATCTTCTTCCTAAATCAACTCAAT
ps_bridge333	CATTCAAACCAATCATCACTCCATTTCCACACACTCATATCATCTT
ps_bridge334	CCTTCTCTTAATCCAACCTTTCCACAAACCAAACAATCACACTTCT
ps_bridge335	TCCATTACCAACAAACCTCAACTTTCTTTCTCAACTACATTCACCA
ps_bridge336	TCCTTTATCCTCTCCTCTCAACTAATCCTCTACCAATCACAACTAT
ps_bridge337	CTCTACTCACCTCACACCACATACAAATCATTCCACATCTATAACC
ps_bridge338	TTTACACTACTCTTCAATTATCACAACCACTAACTCACCATCACCT
ps_bridge339	CTTTCCAATCACCTACTATCTCACCTACCATTAATCACACACACAA
ps_bridge340	TCATCAACTTCTTCCAACTACTTACCATCCTTACACCTCCTCAACC
ps_bridge341	CCTCACTTCACTACTCCATCCATATCTCTTCATCTTTCATCTCAAC
ps_bridge342	TTTAACACCTTTCTTCATCCTATCTCCAAATTTCACCTCTCTCTCC
ps_bridge343	CCTCCATTCCTCTCCTAACACCTTCCTCACTCTCTACCTCTAAACT
ps_bridge344	CCACTACTCATAATCCTCTTCCTACCAACCTTATAACCTCCAAATC
ps_bridge345	CTCATAATACCTTCTCCAACATACATTCCTCTTCCATCCTCATTCA
ps_bridge346	ACCACCACACTACTCCAAATTTCCTCAAATCAACCATTCACTAATA
ps_bridge347	TCATTCAACTTCCAATCATTCCACCATCTCTACACCACAATACACT
ps_bridge348	TTCTCAATTCCATACCTTCTTCTCCATCACAATCACCTCTACCTTT
ps_bridge349	TTTCTACCTCTCCTCTCCAAATCCATTACCTCAAACAACAACATCT
ps_bridge350	ACCAATACCATCCTCATAATACACACCATCCTCACACCATCCATCC
ps_bridge351	AACTCCATCCACCTTTCTACACACAATCTATCCATTCAATCCTTTA
ps_bridge352	ACTTAATCCTCCACACAATCTCTTTCCATCAACCTCCACATCATTA
ps_bridge353	CCTCACACATCACCACATTCCTCTTAACATTCTACTCAACTCTCTT
ps_bridge354	CATCTAACTCATTACTCCACTCTTCTCACCACCTCATTCTACAATC
ps_bridge355	TTTACAAACATCTTAACCAACTCACCTTAACTCCTTTCCACTCCTC
ps_bridge356	CCACCATTCTACAACAATCACTCCTTAATACACTCCATTCTCAACA
ps_bridge357	CTCCATTCTTTCTCTCCTATCCAATCCTTTCCATCAACCTTCACCA
ps_bridge358	TTCTCCTCAACCTACAACACTCTTCCTTCCTTTAAACATTTCACTT
ps_bridge359	ACTTTACTTACTACCATTACACCTCTACCTCCTCTCATTCCACAAC
ps_bridge360	ACCTAACCACATTCCACCACTTCAATCACTTTACCTAAATAACTCC
ps_bridge361	ACTCCACCAAACATCAATACAAATCCAACCAATACAACCATTTCCT
ps_bridge362	TACTACCACACTATTACAATCCTTCCACACCAATACTTCCACACCT
ps_bridge363	ACTTACACTTCCATTTAACCTCCTCTCTAATCACCATCATCTCCAT
ps_bridge364	ACTTTCACCTCATCACCACACATTTCATACCTCACATTATTCCTTA
ps_bridge365	CACCTTCCAACTATTCCTTCTCACCACCTTCTACATTTCCTTCAAA
ps_bridge366	ATTTACCTAACACATCCACAAACCAATCAACTCCTAACACTCCATA
ps_bridge367	ATCAACCATCACTTCACTCCAAACCTATTCTTCCAACTCTACTTAA
ps_bridge368	CTCCTTACCTCCTCACTCTCACTTTACTCAATTTCCTTATTCCACA
ps_bridge369	TTTAACCTCCATACCTCCATCATCTCCACCATACACTACCATTCCA
ps_bridge370	TCCTTACACCAACTATCATATCTACCACCACTAATTCAACCAACAA
ps_bridge371	AAATCTATTACCACTCCACTCTCTAAATCTACAACACTCCTCTCCT
ps_bridge372	CTCCAATACACATTCTCCACCAAACAAACCACTTCTCCTTTCACCT
ps_bridge373	CCACTCACCTAATACCTACACTCTTCTCACTCTCCTCTCTCATACA
ps_bridge374	CACTCTCTAATTCCAACACACACTCCTCCAACTTTCTCAATCTTCA
ps_bridge375	TTACAATCCATCCTAAATTCAACACACATCATTCCAACACACTCTC
ps_bridge376	CCAATATCTCCACACATCCTCACCATTCCTACCACTATCTAATCTA
ps_bridge377	ACTAACACATCCACAATCCTCTATTCCATCCTCACATAAACAACAC
ps_bridge378	TCTCTTCACCAATCTTTCCTTTACACCATCACTCTACCACTACTCT
ps_bridge379	CTTCCTCATTCCTTTCACCACCACTTTAAATACTTCTACACCACTT
ps_bridge380	ACACCACTACTTCAATACACATTACCACACCTCTCTTTCTAATACC
ps_bridge381	CACTCCAACCTATTTACCTACTACACACCTCCTAACCTCAATCTAA
ps_bridge382	CATCCACACACAACCTTACTATTCACACCAATCCTCTCAAACACTC
ps_bridge383	ATTTCTCCACCTTCCTCAACACATCAATTCTTACCACAACTCCTTT
ps_bridge384	ACTCCTCTTATCAACTATCTCTCAACTCCACCATCCTTCAACATAT
ps_bridge385	TCCACCAACAACCATCCTCTCAACTCATTTCTTACCATTACTAATA
ps_bridge386	TTATCTACTCACCTTCCACATTCAAACTCCTAAACCATCACTCAAA
ps_bridge387	ACCACCACACATTTACTTCAAACCTCACTCTTTCCTACAATCTATT
ps_bridge388	CCTCCTTACCACTCAATAATCAAACTTACCTCTCACCTCTACACCT
ps_bridge389	TTAATTCACCTTCTCCTAATCCTTCTACTTCCACATCCTCCTCAAC
ps_bridge390	CTCCACCAAACTCCTTTCCTCAACAAATAATTCAATCCATTCTCAC
ps_bridge391	AACAATCCATTCTAATCACATCCTATCACCACTCAACTTCTTCACC
ps_bridge392	TACACCTAACAACACTACTTTCACCTTCACCACTACCAACAATCTA
ps_bridge393	ACCAATCAACCACCACATATCTCCTCATTCTCTCTCCATCCTACAA
ps_bridge394	CCACTACCATATCTCACTACCACTCAACATAACCATCTCCTCTTCC
ps_bridge395	TCCTACAAATTTCTACCTAACTCAACCTCACACCATCTAAACCAAA
ps_bridge396	CCTTTACACAATATTCCACCACTAACAACCTTTCTTCACTCATCAC
ps_bridge397	TCATTTACTTAACCTTCCACCACTCACAACTTCCATTCTCAACTTT
ps_bridge398	AATTTACCACCTCACTTACATCATCTCATACCACACATCTTCCACA
ps_bridge399	TTATACCTACCTTCTTCTCCAACTCTCATAACTCTCCTCCTCACCA
ps_bridge400	CCTCATAAACACACTCAATCTCCAAACCATTCCTCTAAACCATCAT
ps_bridge401	CTTCCTTTCCTCACCTTCTTCCTCTCACCTCACTTATCACACATCT
ps_bridge402	ATCACCTCACAACTCAATCTAACCAATCTCCTCAAATCTACACCAC
ps_bridge403	TATCAACTCTCTCATTTAACACACTACAATTACACCTCACACCACT
ps_bridge404	TTTAACTCAACTAAACTCCTTCTACTCCTCCACATTTCACACTCAA
ps_bridge405	CCATCCTCCACATCTCATCACTTTAAATACCTCAATCTCACTCTAC
ps_bridge406	TACCTCTCCTACCTATACCTCACTAAACCTTAATCACCTCTCTCTT
ps_bridge407	TCACTCCTCCATACATCCACTCCTCCTCTTCAATATACCTACATCT
ps_bridge408	AACATCCTATTCTCTAACACCAAACCTCAACTCCAATCTCCTTTCA
ps_bridge409	CTCTCCTCTCTTCTCAACTATCTCAATTTCCACTTCAACTACTCCT
ps_bridge410	CACCTCAACCAATCTTTCTAATCCACACACCAACAATTCCTAAATT
ps_bridge411	ACTCACTACATACTATTCCTTACTACCACATCTTTCTACCTCCTCC
ps_bridge412	TCACCTCTCAAACTTCTCTCACATCCTCAATACTATACCTACCACT
ps_bridge413	AACAACACAAACATCTTACCAACCTTCATCACATTCTTCTTTCTCC
ps_bridge414	CACCTCAATCACTTCTACTAATACTCCATCTTTCCTCCATACAACC
ps_bridge415	TTATATCCATACACTTCAACCACCTTCCAAACCTATATCATCCACC
ps_bridge416	ACCTCATCTCTTACTCTTCTTCCATTTCATTCTTCCTTCTACCACC
ps_bridge417	CAACACACATTCTCAACTCTCTCTTCCTCCATCTTACCTCACTCAT
ps_bridge418	AACCACATCATCCTTCATACTCCTCCAAACCAACTTCTCTTCCTTA
ps_bridge419	TCATTTCCTATCAACCAACTAAACTCACCATTCCTCCACTTCTACC
ps_bridge420	TCTACCTCAAATACTCATACTCTCCAACCTCCACTACCAATCATTC
ps_bridge421	TCATTCCACTCTTATTATCTCCATCTTTCTCCAACTCCAATTCACC
ps_bridge422	TCCACAACTCTACACATCATTCATCCACAACTACAACACAATCAAT
ps_bridge423	CTACATACATCCACATCCATCATAACTTCCTCCTTCTCCTCCAACT
ps_bridge424	ACTTTCTTCCATCAATTCTACAATCATACCATCCAACCACACCTAC
ps_bridge425	ACTTTCTCCACTTACAATAATCAAACTCCTCCATCTCCAACCTTTA
ps_bridge426	ACCACCTACAACAAACATACTAAACCAACTTACCTCTCATACCATC
ps_bridge427	CTCTTCCAACTCTCCTTTCAACCTTATTTCACTCTTCACATCCTAC
ps_bridge428	CTACTCATTCCTAACCACACTCATACCTCTCTTTCCTACATCTTCT
ps_bridge429	ACCTCCAACAATCCATCCATCATCCTCTTTAACCATACATCCTCCA
ps_bridge430	ACCAACTAATCCATCAAATCACAATCACCTTCTACTCAACACTCCT
ps_bridge431	CTTTACTACCAACTACTTACCTCCTCAACTCATTTACACACACACA
ps_bridge432	AACTCTCACATCCACACCAATAATAACTTTACATCATTTCACCACC
ps_bridge433	CCTAACAATCAACCATTCACCTAACACTATCCACCTCACAACATTA
ps_bridge434	CTTTCCAACACATTCCACCAAATCCAAACAATCTCCTATTCACAAT
ps_bridge435	AATCACCATTACACCTAATTCCTACTCACCATCCATATCACTCTCA
ps_bridge436	TAACATCATTCAACTCCAATCCTACCACCACTCTTCCTAATACACC
ps_bridge437	ATAATCCTAATTCCAACACTCCAACTCTTCTCAAACTAACACTCCT
ps_bridge438	AACACACATCACAAACACCATTCATATCAACTCTATTCCTCCATCA
ps_bridge439	TTCACCACATACCAACTTCATCCAAACATAACTCCTTACAAACACC
ps_bridge440	CCTTACCTCCTACCATCTCTCACAATTCCTCCTCCTTCACATTCAA
ps_bridge441	CATTTCAATTCACCTACACCATCCTACACCATCCTTCCATCATTCT
ps_bridge442	TCTCCAACTTTACCTCTTCTTCACACCTCTCCTATTTCAATACTCA
ps_bridge443	TCAACTTTACACACTCATTCAACCAAATCCACACCACTTTACTCAA
ps_bridge444	AACATCCAAATAACATTATCTTTCCACACACCTTTCCTACACCTCA
ps_bridge445	ACTTCTCTACCTCTTAAATCCATAACTCACCATCCATCTTCCAACT
ps_bridge446	CTCACATACATTCTACCTCTTACCTCAATCCAACCATCAACAACCA
ps_bridge447	TAACACCTCACTACTAACACACCATATTCTCTCTTCACACAACCAA
ps_bridge448	ACCACTCCAATCAAATTCCATCATATCTCACACCATCCTAATTCCT
ps_bridge449	CTTCACAAACAATTACAACCTAACATCCACCTAACAACACCTCAAA
ps_bridge450	ATCCATCCAACTTCCATATCCATTAAACTCACCACCAATACACTTC
ps_bridge451	TAACTCATCTCTCACCATCACACACTTCATACCACTTCACTCTATT
ps_bridge452	AAACACCTCTCTCTTAATCTCCACTTTAACATCTTTCACATCTCCA
ps_bridge453	TTATTACAATCAACTTACACCTTCCATTTCCACTCAACACCTCTCC
ps_bridge454	AAACTATCTTCCACATAATCACCACTTTCCACCACTCTATCACTAC
ps_bridge455	AACACACCATCAACCTTCACATCTTACATCTAAACCTCCAAATCTT
ps_bridge456	TCTTACACACCTTAATTACAACACAATCAATCTTCCACTCTCACCT
ps_bridge457	TAACCTTCCTCCATATCAACTCTAAACCACATTTCCAATCACACTC
ps_bridge458	ACCACCTACTTCCACCAATATTCAACCTTCAAACTTATTACCAACC
ps_bridge459	CTCTCCACAACCTTACTCTCCACCTTCAACACTTTAACCTTCTCTA
ps_bridge460	TCCACCTTCCATACACAACCAATAACACACACCTAACAAACTAATA
ps_bridge461	CATCTCTATATCTCAATCTACCTTCCATCACCTCCTCTATTCCTCC
ps_bridge462	CTCACTCACCACACTCTTACACCTAACACTCACAATACTCTTTACA
ps_bridge463	AACATCTCATTCAACCAATATTTAACTCATCTCACCACAAACACCA
ps_bridge464	CTCACCAACCAATCCTTCACACATAAACACAACCTACACCTTATTT
ps_bridge465	TCACTTCTTTACTCAATCCACCTTTCCAATCTTACACCACTTTCTC
ps_bridge466	ACAACACTTCATCCATTCACCTTTCCTTCTAACCACAATACACACC
ps_bridge467	CTACCTTAAACTTCACCACTTACTCATTCAACCTCACAACCACAAT
ps_bridge468	TTTACCATTCCTTTACTATCCTCCACATTTCCTCTTACACACCTTC
ps_bridge469	ATTCACACACCATCTAATTCATTACTTCCACACACTCCTTATCTCA
ps_bridge470	TACATCACCTCCACAAATCACACCAAACCAACTCTATCCATTTAAC
ps_bridge471	TCACATAACCTTTACCTCACTCATCACTCATCAACCAACCAACCAT
ps_bridge472	CATCAATACCTTACACTCCTTTACCTCATAACCTCCATTCCTCTCT
ps_bridge473	ATCCTACCACACTTTCCACACCTTAAACTACTCAACACTATTCCTA
ps_bridge474	ATAACCAACCTTTACTCACAACAATACTTCCATCCACAAACCTTCC
ps_bridge475	ACCACACCAATCCTCAATCCTCTCTCAACTACTATTTCCAACACCA
ps_bridge476	ATCATCTCTATCCTAAACCTCTAATCCAACCTTCTACCAACACACT
ps_bridge477	TCATCACACTCCTCCTACCTCCACCACAATTAAATCATACATTAAC
ps_bridge478	ACCAAACCACACATACATAACCTTCATCCAATATCATAACTCACCT
ps_bridge479	CTCTATTCTCACCTCTTCACTCTAATATCCACAACCACATACTCCT
ps_bridge480	CTACACAACCAATACTCACACCACTCACTACTTCCTATCTCACTTC
ps_bridge481	AAACACCTTTCCTACCTTCATCTACTACTCACTACACTCACATTCC
ps_bridge482	AAACCTACACCTTTCCTCTCCACATATCATAACTACCATACCAACA
ps_bridge483	ATTCTCCTATTTACCACCTCTAACAACCTTACCATCTATCTCCTCT
ps_bridge484	CTCATACAACCATTTCACACAACACACTTCACTCATCACTTCTTTC
ps_bridge485	TACCATCCTCACCACACATTAACCACACTTTCCTCTTAATAAACTA
ps_bridge486	CCTACCACCAAATCTCCTCCTACTACTATCTACACTTTCTTTCCTT
ps_bridge487	TCTCACATACAATACACCATATCAAACCTATCAACACCTCAACCAT
ps_bridge488	ATTCATTTCCATCCACAACACTCATCATCTCATCATCTCTTCTTCC
ps_bridge489	ACTCTCCACTATCCAAATCTCATTCCTCATTACATCATTTCCACAA
ps_bridge490	ACTTCACAATCACCAATTAACATTCACTCCATCCTTTCCACAATAT
ps_bridge491	TCTCATCAACCTCACACTCTTCATCAACTCTAACCACTTAATCCTC
ps_bridge492	AACTTCAACTATATTTCCTCCTACCACTCCAATCCTATCCTCTTCT
ps_bridge493	ATTCCTTCATATACCACAATATCCTCCTAACTCCTTACCTCTTCCT
ps_bridge494	ATCTCACCATACTTTCACCACACTTAAATCCTTCTCTCACATCACA
ps_bridge495	CCACATCATTCCACTCAACACTCCTAACTCCTCTATAATAAACCAA
ps_bridge496	TACTCCTCCAATTTACAATCTCTACAACACCATTCAACCTCAATCT
ps_bridge497	TCCATTCCAATCCTCCAAATCCATTCTTCCTCACCACTCACCATAT
ps_bridge498	TTACCTCCAATCTAACCTAAACTCTACTCCTCCACAACACCAATTT
ps_bridge499	CCAACCACATCCAATCATAATATCCACCTATTCTACCACCTCTCCT
ps_bridge500	ACCTTTCTACTCTTCCTCATCAAACTCCACACTACACATCCTAACC
ps_bridge501	CTTACTACCAATACAACCACCTAAACTTACTCCTCACCTCACATTC
ps_bridge502	CCAACATTACACCACCTTCATCTACATACACAAACTTCTCTCTCTT
ps_bridge503	CTCCATCACACTCCTCAATATCTCATCCTAATCCTTCACACATCAA
ps_bridge504	CACCTACATCCTATACAATCTCACCATCACTCCTAACCTATACCTC
ps_bridge505	AACTCCACAATTTCCATCTCACAAACTCCACAACCTACTTACATTA
ps_bridge506	TCCACCATCCTAAACCTACCTCATAATCAACTTATTCCACTTTACC
ps_bridge507	CCACTCATAACTTACAACATAAACTCCAACCACACATCCATCTACC
ps_bridge508	AACCTTTCCACACATTCCTACTTATATCTACCATCACTCACACCTA
ps_bridge509	CACTCTCCTAATACCTTACCTTCTATACACAACCTTCACCACAATT
ps_bridge510	CTCATACTACCTCAATTTCTCCTCCTCAACAACACCACATAACATA
ps_bridge511	CCACTCCACTTTCAATATCAATCAACTTCTCCTTATCTCTCCAACC
ps_bridge512	ACATACTTATCCATCCAAACTACCTTATCACAACCTAAACACACCA
ps_bridge513	CCTTTCACAACTCTTTACCTCTCAATTCAACACCTCTACTCCTTTA
ps_bridge514	TTTCCAAACATTCATCCATCCACAAATCACTACACACTCCTAAACT
ps_bridge515	ATAACCTACTTCAATTCATCCACATACTCACCAACCATCAATCCAT
ps_bridge516	AACACAAATCACTCCTCCTTCCATCACAATCATATCACTAATCACC
ps_bridge517	TACCATTCTACTCTCTACACAATAATCCTCTTACCACATCCTCACC
ps_bridge518	ACCACTTTCATTCCTCATACCACTTCTCCTTATAACTCCTTCATCC
ps_bridge519	TCCATCTACCTTACCAATACCACTTCCATTCATATCTCACCACATA
ps_bridge520	ACCTTCTCACAATTCCTCACTTCTCCTTACTCATATCCATCTCTAC
ps_bridge521	CAACACACCAATTCACCTTATACCAACCTCAATATCCTTTATCCAC
ps_bridge522	TCCATCAATCACCATCTCCATCACACAATTTCTACACCTACTCACT
ps_bridge523	CTCTACCACAACCATTTCCTCAACTCTTCTACACCATCTTACTCCT
ps_bridge524	CTCTTTACAACCTCACTCCAACTTACTTCACTTACCACATTTCCAA
ps_bridge525	CAAATTCTTCCACAACTCCTTTCCATCAACAATACAACCATCACTA
ps_bridge526	ACCAACATACCTTCTCACACTCACACTCATAATCTCCTCTCATCCA
ps_bridge527	CCAATCATACCACCTTATCTCTTCATACCAACCACAACCTACACAA
ps_bridge528	ACAATTATCCTAATCCTATCATCCACTCTTCCTCAACCTTCTCACA
ps_bridge529	TCCTTAACCACCATTCCTTCCTCTTCATTCCTATCACTCCATAATA
ps_bridge530	TTAAACATCTTCACCACACCTTCTTCCTTCCTTCATATTTCTCCAC
ps_bridge531	CCACCTCCTCATTTATAATTCCTCTCTTCCTCAATCCTACACCAAC
ps_bridge532	ATCTCTCCTCTTCCACACTCTATCAACCACACACTATTTACCACTA
ps_bridge533	CCTCACTCATCTCCACAACAATACCAATTACACTATTCTACTTCCT
ps_bridge534	CTATCATCCATCTTCATCATAACCACACCTTCCATTCCTACACTCC
ps_bridge535	TCTACTACACAAACTTTCAAACACCTTCTACTACCACCTCAATTCC
ps_bridge536	TCCTCTACTTACCAACTACCTTTCAACAAATTCAAATCAACCACAC
ps_bridge537	TCCTACCTTCTTACAATTCACTACCATCCATTCACCATTCCATAAT
ps_bridge538	TATCTCCTCATCTTCCTAACCACCAACATACTCACAAACTCACCTC
ps_bridge539	CCTTCCTACCTTCTTCTACAATACACCACAAACTTTAACAACCTCA
ps_bridge540	TTTACATTCTTCCACCTTAATACCAACATTCTCCTTACCAACACCA
ps_bridge541	CTACCTTAACACAAACCACCATAACACCAATATCACCTTCCTTACT
ps_bridge542	ACTTACACACCTACCACATACTCCTCATTCAACTTCCAACATACCA
ps_bridge543	TCCTTCCAACCACTATCAATTCCTTACCACTTATCCTCAAATACAC
ps_bridge544	CTTCCATCCTCCACCTCATCTATTACACTCAATCTTCTATTCCTCC
ps_bridge545	TTCCAACTTACCAATCCACCTTACACTTACTACCACTCTAACACTT
ps_bridge546	TCTCATAAACACCAACAACCATTACATTCTAATCCACCACCAAATC
ps_bridge547	ACTTACTTCCTACCTCATCCATTCCAATCCATACTACTTACTACCA
ps_bridge548	AACCTCTCCTCATTCCACACTTTAAATTTCTTCTAACCACTACCTC
ps_bridge549	ATCTATTCCTCAATTCACACCACTTCTTACATTTCTACTCACCACC
ps_bridge550	TTAACTTCTTTCACTCATTCACTCTTCCTTTCCAACCACCATCACC
ps_bridge551	TACACAACTACCACTCCAAACCACTAATATCCACATACTCACCTAT
ps_bridge552	AAACACCTTTATCATTCCTCAACACAATCACTCCATCTCCACATAA
ps_bridge553	TCTCCACAATCATTACCAAACATATACACCACTACCACATCCTCTA
ps_bridge554	CTAATACACACTTAACTCATCCACTCTCACAACTCTCCATCCATAC
ps_bridge555	AACCACACCTAACTTAAATCTTCTCTCCTATCACATACCTCCACTT
ps_bridge556	CAACAACCACCACAATCTTCTACCTACTAACTACCTTCCTTACCTT
ps_bridge557	AATAACAAATTATCACACAACCAACCACTTTCATCCTCACAACTCC
ps_bridge558	TTACCATCTCTTCCTTAAACCAAACACTCCTTTCATTCTCACATCC
ps_bridge559	TCTTTACATTTACAACCATCCACTCACCTACCTCACACCATTAAAC
ps_bridge560	TTCCTACATAACCTCTCCTCTCACTCTAATCATCCTTACTCCTTCC
ps_bridge561	TCCTAAACTCTCATTCTCAATACCACCATTCCAAACTTCCACCTCC
ps_bridge562	CACCTACATCTCTCTCCTCCTTTCCTCGACACCTAACCATCTCTAA
ps_bridge563	CCTCTATCCACAACACCTCATAATCCAATTATACCACTCTCACAAT
ps_bridge564	TTTCCTAACACACAATTTCCAACTACCTCTAATCTCCACAACCAAT
ps_bridge565	AACTTATTCATCCTCCAATTCAACCTCTCTCCTAATCACCTCCTCC
ps_bridge566	TCAATTTCTCCACAACCTTCATCATCCTCATCTCAACCACAAATAA
ps_bridge567	AAACCTCACTCCAATCAACCATTTCTCCACCAATTCCTTACCTACT
ps_bridge568	CACAAACATCTAACCACACACTTCACACTTCAAACCTACTCTCAAA
ps_bridge569	ATTCTCACTCTTCTCAACCACACTCCATCTCTTCTCCTAAATCTAC
ps_bridge570	ACTTTACCTCACATTAACACTCACCTCTCTCTTCACTCCAATCTTT
ps_bridge571	CAAACCTTCTTCACATACCTCTTAACCTCATCCTTCTCATACTCAA
ps_bridge572	TTCTACCTCCACCTACTCCATAACTTACATCAACTTACTATCACCA
ps_bridge573	CTACATACATCATCCACCTAAACACATCACCACACTACTTACTCTC
ps_bridge574	TAAACCTTCCTCTTTCATACATCCTTCTATCCAAACCTCATCACAC
ps_bridge575	CCTAACCAATCCACTCAATACACTACCAATTTCATCTCAACCTCTA
ps_bridge576	TTACACACCAAACACTCTAACACTACTCAAATCTCTCTAACCACAA
ps_bridge577	ACACATCTCACCATCAATATCAACCTCAAACTCACAACTAATCCAA
ps_bridge578	CACTTTACAAACAACCTCCTACCAAATATCAACACATTCACTCTCC
ps_bridge579	TTACACCTTCTTCCATCACCACTCACACATACCAAACATCAAACAA
ps_bridge580	ATCAACATTCACAACTACCAACTTCTTCCTCTACTCCTTATCATCC
ps_bridge581	ACCACACCACACTATCCTAACACAACATCTCACTCACCATATCATT
ps_bridge582	ATCATAACAATCCACAATTATACCACATCCAACTTCCACCTACCAT
ps_bridge583	CCAATAACCACAAACACTAATTCCTCACTTCTAACACCATTTCCTC
ps_bridge584	TACTATCTCCACTTCCTCCTCAACCTCCTAATCCAATCACTACTAC
ps_bridge585	TCATTCACAACCATTACCTTTAACATTTCACACTCTTTCCTCCTTC
ps_bridge586	AATCTCAACAAACCACAATTCTCTCCACTCCACACATACTCACACA
ps_bridge587	CCATCCTACATCCACATACTCTCACATCTTCAACATCTTCCATTTC
ps_bridge588	CCTCATCCTACATTCTCTCCAAACCATCTCACTCTAAACTTTCTTC
ps_bridge589	CAAATACCAATCTCCATCCTCTAACCATATACACCTTCACATCTCA
ps_bridge590	CCATCTCCTACCATTCCAATACACTCCATATTCCTCAAACCTCAAT
ps_bridge591	ACTATCACACAACTCCACTACATACATTCTCTACCAAACATCACAC
ps_bridge592	TACTCCTAACCATCAACCACACTCATTCTTCACTTTCTCTCCTAAC
ps_bridge593	TCACTCACCAACTCTTACTACCTTTATCTAACCAATTTCCTCCTCC
ps_bridge594	TTTACTTAACACTACCAATCCATCACAACATCCACTCTCACCAACC
ps_bridge595	CCAACCTTCCATCTCTCCACATTAAACACTTCCTCCACTTTCTACT
ps_bridge596	TAACATCACTATCTACCAAACCAAACCAACATCTACACTTCACCTC
ps_bridge597	TATCTCTCTAAACTCCACTCAAACCTCCATACATACTCCAACACTA
ps_bridge598	AACTTACTCTACCATCCTACTTCACTACACCATTTAACCAATCACC
ps_bridge599	TCATTCCTAACTCAATACTCACCATCATACCTCCTCCAAACAACAT
ps_bridge600	CCACTTCTACCTATCCATTATCTTCCTTACTCCTCACACATCCTTC
ps_bridge601	CCAATTCTACACCTCATACTATCCAACCAATTCCTCCAATCACATT
ps_bridge602	CAACTACACCACTTCACACAATCACCTCTCATTCACTAATACCTCA
ps_bridge603	CTCAAATTCTCCACCTCTATCACTCATCCTCATAACCAATCCATCC
ps_bridge604	TATCCTCTTCCTCACCTTCATCTTTCTCACCTATTCCATAACCTTC
ps_bridge605	TACCATACCTTTCCTACACTCCTATCTTCACATCACCAAACTCTAT
ps_bridge606	CCTCCTCATATCCAATCCTCCTCTCATTTCTACATAATCACTCACC
ps_bridge607	TCCACCTCTTTCCTCTCCATATCCACATTCTTTCTACTCACTTAAA
ps_bridge608	CTCACTAATTATCTCACTCAAACCTTACAACTCCTACCTCTCCTCT
ps_bridge609	TCATCACTCCAATCCTTTCCACAACAATACCACCTTCATTCCAAAT
ps_bridge610	TTTACTCCTTTCATCATTCTCCTCCAACCTTCACAACTTCAACACA
ps_bridge611	CACTCCTCAAATACAACTCATACACCAACACTCCTTACACACACTA
ps_bridge612	TTCTTCTCATTCACACCAAACCACCTACATTCTTTCCAACTCCTCT
ps_bridge613	AACCATCCACCAATCTCCAACCTTTCACTCTCTCATTTATTTCATC
ps_bridge614	CCTATCATCCATCTCTAAATCCACTCCTTTACACCATCTACCACCA
ps_bridge615	CTAACACCACTTCCATTACATTACTCAATCACCTCTCTATCCTCCA
ps_bridge616	ACCTCTATTTCACCTCAATCCTCAATCAACTCCAATACAACTACCT
ps_bridge617	TCACAACCACACCATACCTCCTACCTCATATTCAATTTATCTCAAT
ps_bridge618	TTTCATTACTTTCCACCTACCAACCAAACCACTACCATCTCTCTTC
ps_bridge619	ATCTACCTCCACTCTTCTCAACATCCTCCTTAATCCTTCTTCCACT
ps_bridge620	TCCTCCTTTCATAAACCATTATTCAACATTACCTCCACCTCCACAC
ps_bridge621	TTTAACTCACCACATCTACTCAATACACATCAACTCCACAAACCTC
ps_bridge622	TCCATCATATTCCACACAACTTCCAAACCATCACACACAACACATT
ps_bridge623	ACTATATTCACCTTTCCTCCTTCTACTCCATCTCTCATTCTACCAA
ps_bridge624	AACCACTCTCTTCACTCCTAATTACTTACATCACCTTCCATTTACC
ps_bridge625	ACCTACATCCTATAACTCCTTCTATCCACTCCTACCATTACCATCC
ps_bridge626	ATCAACACTACTCATCAAACACACTCCACACACTCTTAACACTTAC
ps_bridge627	CCTCACATACACACATCATAACACACTTCATCCTTTCCTCCTTCAC
ps_bridge628	CCTCCACATCTTCTCCTTCATAACATCTTAATTTCACCTACACACA
ps_bridge629	TTCCTCCTTCACATTACTACCATCCTTAATCTCCACACCACACAAC
ps_bridge630	CAATCACTTATCACACAACCAACTTTCCTCCAATTTCACCAACTAC
ps_bridge631	CCACTTCTTCATCCAACCAACTACTTATCACACCACTCTCTCAATT
ps_bridge632	CACCTACCTCTCCTCCTCAAATTCATATTCATTCCACCACAATACC
ps_bridge633	CTTCTCCATCACACCTCATCTTCCTAAACCAATATCAACCAACTCT
ps_bridge634	CCTCTCCACATATACACATACCTCTCTCTCATTCCTCCTCCTATTC
ps_bridge635	ACCTTACATATCACCTCAACCTCTACCTAATATCTCTTCCACTTCC
ps_bridge636	CAATCCACCTATCTAACATCCACTCATTACCACAATAACCACCTCT
ps_bridge637	TCCTCCACACTCACTCTTCCAATCACTACAACCATACTATAACTAA
ps_bridge638	TCCAATCTATCCTCTCTACTCCACACTATCAACCTCCAATTTCCTC
ps_bridge639	ACCTCCAACCATTTCTATCCAAACCAATCTCATATCATACCAACCT
ps_bridge640	CACACACCTAACACTTCTCACTACACTAATATCACATCCATCAACC
ps_bridge641	AACACTTACACCAACTATTACTTCTTCCACCTTTACCACCAACATT
ps_bridge642	CACACTCATCCTTTACACACACCATCTTATACTTCTCCATTCCACC
ps_bridge643	CCTTTCCAAACCACACTCCAACACACTCAATTCTATTAATAACCTT
ps_bridge644	AACATCTATTTCCATATCCTCAACCAAATCCACCTCTACTCCAACT
ps_bridge645	ATACTCCACTAATACTCAACTTCTCCTCCACCATTCTCTAATCTCC
ps_bridge646	ACCACCTTATCTCCTCTCCAACTTCTACTACTTTCATCATCAACAA
ps_bridge647	TCTCATACATTCCACCTAACCTCACTCTCAACAACTAACACTCCAT
ps_bridge648	AACTTCACCATTCACCAATCCTCTATCCTCACATCACATCTTACAA
ps_bridge649	CAAACCACAAACTACACCACTACTCAACTTTCATACTTCACACAAT
ps_bridge650	CCATCTACTTAACCTATCACCAACTCCACATAATCCTTTCCTCACT
ps_bridge651	TCACCTCATCTACTCTAAACATCTTCTCCTCATTCCAACAATTCTC
ps_bridge652	CTAACTCACCTCACTTCTATACACAACACATACCATTCATACCACA
ps_bridge653	CTATACCACTCTCATCTTCCACACTCCAAACTACTCAATAACACCT
ps_bridge654	CCAATAACTCACACCATCTCCATCACTATCCACAATCTCTCTTCAA
ps_bridge655	CCACCATCTCTCTAACCTTTCCTCACTCACTTTACACATACCTTCC
ps_bridge656	TCAATAAATCCAATTCCTCTCTTCACCATCTAAACCACACTATCCA
ps_bridge657	CAACCATTTCCTAATCCACTTCACTTCATCACAACTTCCTAACAAC
ps_bridge658	CCATTTCTCACTTTCCACAACTTAACAAACATCATCCATCCTCCTA
ps_bridge659	ACACTCTTTCCTCACCTCAATATAATTAACCACACACCTACATCAT
ps_bridge660	CCACACTCAACAAACTCATCCTTATCACTACTACCTTTATCACTCC
ps_bridge661	AACTCCTCCATCTCTCATCCTAATCTCTCTACTTTCTCTCCTTCTA
ps_bridge662	ACTTCCACCTCTACTTTATTTCACTTCCTCCTCTAAACTCTACTCT
ps_bridge663	AACCACTATTCAACATCACATAAATACCTCTCCACACACTCCACTT
ps_bridge664	TCCACTCTTACACTACAACACCTTAATATCTACCATCACTTCCACT
ps_bridge665	TATCTTTCAATCCTTCACCTTCAAACTCCATTACCTTCTCTCCATT
ps_bridge666	CACCTATACTCCTCCATACCATACACCACACTCCAATCCATATCAC
ps_bridge667	CACCATCAATCCTCCACCAACTCAATCTATTATCCACACCTTATTA
ps_bridge668	TACCATCTATCAATCCTAAATTCACCAACTCCTCTCCTTAAACCAC
ps_bridge669	ATCCAACCTTCATTCTTTCACACCAATACACTAACACATCCACTTC
ps_bridge670	TCTTTCATCTCAACCTATCACAACCTCTTCCAACTTCTCACTAACT
ps_bridge671	TTACTCAACTCTTCATCAACTAAACATCACCACACTCTCTACTCAC
ps_bridge672	TCCATCACTCCAAACTCTCAACTCACAATACTTAATAACCTCCATC
ps_bridge673	TCATTCATTTCTACTCCACAATTTCCAATACTCCATTCCACACACT
ps_bridge674	CCTACTCCTCATCCATTAACCACTTCTTCACTATCCTACATCATCA
ps_bridge675	ACAACCAACTATCCACTCAATACATCCATTTCTCACTCTCTTTCCA
ps_bridge676	ATCACAACACCTTCAAACTACACTTCCTACCTTACATTCACCAAAC
ps_bridge677	CTCCACCTTAATCCATACATCCAATTCCACTACTCTCTACCAAACC
ps_bridge678	TCCACAACACAACCATTTCACTCCACATCAAATATCCTACTTATCA
ps_bridge679	CACACCACACAAACATCCAACTTTACCTAACCTTCCATTACCATCC
ps_bridge680	TACTCTTATTCCACCACTACTCATAACCAAACCACACCAAATTCCT
ps_bridge681	AACTTACTCCTCCTTCCAACCAATATCTCCATCACCACACTACTAA
ps_bridge682	TTTCATCTCAACCAAATTTCCTTTCACACATTCCACTAAACCAACA
ps_bridge683	AAATTCCACATCTCCTACTCACTTATTACTCCAAACTTAACCACCT
ps_bridge684	AAACTAACTTCCATATCCTTTCCACTCAAACTCTCCTACACCACCA
ps_bridge685	CCACATCTCCACAATTACCTTTCCTTCTCATACTTTCCTTCCATAT
ps_bridge686	ACTTAACTCTCAACATACTCCACCTCCAACAAACAACTCATCCTCC
ps_bridge687	CAATCCTACTACTAAACCTACCTCCTCATCTCACACACTTTCTCTT
ps_bridge688	CATTAACCTTCCTCCTCTACTCCACTCTCCTCTCACTAATCACTCT
ps_bridge689	TTCCTTTCACACCATTTCAACCACAACTCTCAACCTACTCCACATT
ps_bridge690	TCACCATACTCCTTTCATCTTTCACTCCAACATTCACAACTAACAC
ps_bridge691	ACAATTCTCATTCTTCCACACCTAATACCACACCAATCTCTCTCTC
ps_bridge692	ACTACATCACCATTCTTTCAATCCATACTCTCTCCACTCACTAAAC
ps_bridge693	CCAACTTCCACATCCTAACCTCTTCAACTCCTACATCTAAACATAA
ps_bridge694	CACACCATTCTATAATCCTACACTCACCTTAATCATCCTCCTCACT
ps_bridge695	ATTCCATCCATATCTCTCACCACTACCACTTCCAACCAACCTTTAA
ps_bridge696	AAATCCTCTACCTCTTACTCCACACTCACCTCCATAAATTTCTCAA
ps_bridge697	TAACATCTCCAACCTCTCACATCTCATCACTTTCAACATTCATCTT
ps_bridge698	ACCACTCTCATTTCCTCAACCTCCACCTATCTCTTATTTCTAACTC
ps_bridge699	CACAACTTCTTCAAACTACACTACTCTCACAACCATCATTCTCCTC
ps_bridge700	CACCTCTTCCATACTTCCACAAATTCACCTTCTTCTTCACCTTTAC
ps_bridge701	CAACCTTCCAAATCTTTCCATTCTTCATCCACACCTCTACACTCTT
ps_bridge702	CCTTCCACCACACTCTTTACATCATAACCTTACTACTACCTCCAAT
ps_bridge703	ACATCTCCAACTACCTTTCCACATAAACTCCAACTACCAACCTTAC
ps_bridge704	TCTCCAAACAATCACACATCAACCACCTAAACCTAAATTACATCCA
ps_bridge705	CCTTTCAACACTATTACTCTTCTCCTTCCTACCTCTCCTTCCTTTA
ps_bridge706	TCCTCTCTTACTCTCTCTAATCCTTCCACACATAATATCTCACACC
ps_bridge707	ATCCTCATCCTAACTCTCACCTTATCCATCCTCTTTAACCACAATC
ps_bridge708	TCTTATATCCACCTAATCCATAAACACCTCTACCAACTCACCACTA
ps_bridge709	CCACTCCTACCTAATCACTCCTTCACTCTCCATCATTAATCCAATA
ps_bridge710	CCACTCTACTCACACATCACTCACCATCATCTCTCCTCAACCATCT
ps_bridge711	TTTACACACTTCTTATCAACTCTTCCACATCCTCAAACCTTCACTA
ps_bridge712	ATCCACCAACTCACCATCATCATACCATCCTTAATCACTATCTTAC
ps_bridge713	AACCACCAATCCTAAATCCACCAAACCTTCATTCCACAATTCTTAC
ps_bridge714	AAACCTACTCCATTCTTTCCAATCCTTAACCTCCTACACCAACTCC
ps_bridge715	CTTCTTCCATCCAAATACCATAAACCTCTCCTATACACACCACATA
ps_bridge716	TCTAAATCATTCTAACACTACACCACCTACCAATTCCTACCAACCT
ps_bridge717	ATTATCCAATTTATTCTCCTTCCACTTCTCACTTACACCTCCAACC
ps_bridge718	ATTCCTCCTTCTCCACTTACTACACACCTACCTAACCTTATCCTCC
ps_bridge719	ATATCTCTTATACTAATCCATCACTCCTCCAATCACACCTCTTCCA
ps_bridge720	CACACATACATACCTACTTCTACACACTTCTATTCACCAACACACT
ps_bridge721	CTCTTATCATCCAACACATACTCTTATACCTCACCTTCCTACCACT
ps_bridge722	TACCAAATCTTTCCTCCTCTCACTACTATCACCTCAACAATACCAC
ps_bridge723	CTACTATCCTCCATCTAACACCATTTCTTCCAACATAACTTCACCT
ps_bridge724	ACATCACTCTCCTACTCTCTCCAAACTACCTTACAAACCAAACAAC
ps_bridge725	CATTTAACCTAAATCACCATCACATACTCCACATACCACCTTTCAC
ps_bridge726	ACCAACACACATACTTCCTCACATCTTAACATACACACAATTCACA
ps_bridge727	CTCACCTTAATTCAACCTACTCACCTCTTCACACTTAACACTTCTT
ps_bridge728	ACACTCAAACTACCTCCTTCACTACATACTCCAACAATCTTAAACA
ps_bridge729	TACTATCATCAACCTACAACTTTACCTACACCTACCATCACTCCAA
ps_bridge730	AATCTCCATCTACCACCACATCTTCATATTTCACTTCATTCCTACC
ps_bridge731	ACAAACCTTCCTTCATCACAAACCTTAAATTCTCTTACTCTCACCT
ps_bridge732	CTCCTTTCCACCAACTCAATTATTACTTCACTTTCTCAACACATCC
ps_bridge733	TCACTACCAATCAAACACTACCATTCCACAACAATCCTCTCTAACC
ps_bridge734	TCCATCCTTCATCCTCAACACCACACAATCATTCATTTCCATTAAC
ps_bridge735	CCTCTTCCACATCCAACCTATCACCAATCTCATTCTCACAATATCT
ps_bridge736	CTCACCATCCTACTTCTCACCTACACTTCAATCCTTTCACTCTTAT
ps_bridge737	TCCATCACCAATCACAAACTCCACTCACACTTCTCATCATCTCTAT
ps_bridge738	CTAACCTATCATTTAACCAATCTCCTTCCTCCTATACCACTCACCT
ps_bridge739	TACTTACCTACCATCACCTACACAATACTCACTACACACCTCTCCA
ps_bridge740	TACACCTCTCACCACTAACACAATACAATCTCTTACATCACTCTCA
ps_bridge741	ACTCAACTACACTTCACCATCTCCACTAATCTTCCATCCTTATCAA
ps_bridge742	TTCACTCTTCTAAACCACTATCAACTTTCTTTCACCACTCCATTCA
ps_bridge743	CCTCCACCACTCCTTAATTATCCACATCTCACACCTCAAATTTATT
ps_bridge744	AATTCATAATCACATCACAACTATCCTCAACCACCTTCATCAACCT
ps_bridge745	CTTCTCTTCACTTACACAACCAACTCTCTTCTACATCACCATCCAT
ps_bridge746	CTCTCACACTTCATTCCTAACACTATCACACCAACTACCATACCAC
ps_bridge747	CTAATTCTCACTCCAAACCACACCTAACTCTTCAATCTTCTTTCCT
ps_bridge748	TCAACCATTTCATCTCAAACACACTTCATTCTCCACTACACCTATA
ps_bridge749	CCTCCACTCCACACTTTCAACAATTCCTCATTTACACCTACTCTCC
ps_bridge750	ATAACTCCTTTAACCTTCACCAATCTCATAACCACCTTCCATACAT
ps_bridge751	TCATCATCAACCACTCCTCTCTTCTCATTATCACCATCTCCTATTA
ps_bridge752	CCTATCACTCACTACTCACACACCTCTTAATTCCACAACTTTCTAA
ps_bridge753	TCCTTCCATCCAAACCTTCACATTTCAACACCATCAACACTCATTA
ps_bridge754	TAACCAACCAATCTTACTCCTTAATTCACCACAAATCACTCCTTCA
ps_bridge755	ACAATCACTTCCATAACACAACCTACCTTCTTCTCAACACAATCTA
ps_bridge756	CACAACTTCCTCCTTACACTCCATTATCTCTTCTCTCACAAACCTA
ps_bridge757	CACCTCCAACACTCTCTTAACACACAAATCCATTATCCTACAACCA
ps_bridge758	CTACCAATTACTAATCAACAATCAACCACCTTTACTCCAACCACAC
ps_bridge759	AACCAATCTCTCTAATTCAACCTCTCCACTTAATCAACCATTCCAA
ps_bridge760	CTACACCATACACCAACATCACAACCACAACATTCCTCTTTACCTA
ps_bridge761	CTCCTCTCACTCCTTCTCAACACCTAAATTCACACCTTTCTTTACT
ps_bridge762	ACATCAACCACTAATCACCTACATAATCTACCTCTTCCATACACCA
ps_bridge763	TACCTCTCCAATCCTACCATAACCAATCCTCCATTTCACTTCACAA
ps_bridge764	ACCTCTCTTAAACACTTTCCTCAACCTCTTTCTCTCAATCACTCTT
ps_bridge765	CCACACATCAAATCCACCACATCACAATACCTCTCTATCATAACAA
ps_bridge766	CACAAACACATATTCCACTTTCAATAACAACTCTCACTCTACCACC
ps_bridge767	TCCACCAACTTACCTACCTCCTACTTACCTTAACTTACACCTCATT
ps_bridge768	TCCACTTATTCTATCTTTCAACACCATCCTCACTAACACCTCTACT
ps_bridge769	ATTACCTTAAACATCCTCACAACCTTCTCTCACCACAATCACTACC
ps_bridge770	AACTCTCTCACTCTCTCTTCTTACCTTCTCCATAAATTTCACACCA
ps_bridge771	TTTCTCCTCTCCATTCCTCATACAACAACCTAATCACCACTTTAAC
ps_bridge772	CCAAACTCTCAAATCACAATTTCACCACCACTACACTTATACAACC
ps_bridge773	TAACTCCAATATCACACCACTTAAACTAACCATAACAACCACTCCA
ps_bridge774	ACCTATCAACCTTTCATCCACTTCTTCAATACACTCTTCACACCAT
ps_bridge775	TTCATCCTAACTCACATTTACAATCAACCTTCACTTCACCTCTTCA
ps_bridge776	CCTAATCTTCCACAATTCCTCTACTCAACAACTATCCATCCTCCTC
ps_bridge777	TTACCACTCTTTCTTACCATTCCTCCAACACCAAACCTACTACATC
ps_bridge778	ACATATCATATTCCACTCCTCTCCAATTATCCTCCATCTCCACCTT
ps_bridge779	CCTCTCCACCACAATAACTAATCCTACATCCTCACTACTTCTCCAT
ps_bridge780	TCTAATCTTCTCATACTCACACCATAACCTCCTCCACCTAATCTCC
ps_bridge781	TACTCCAATCCATAACCACCTTACCTACACCTAAATCCTAAACAAC
ps_bridge782	ACCTCAAATTACTTACATTCCAATTCACACCTACCTCTCCACTACT
ps_bridge783	CCTCACATAAACACTCCTCACCTTTATATCCTCACACATCTCAATC
ps_bridge784	CTATTCCACTTATACCACCAACCAATCTTCTCATACCACCAACTCT
ps_bridge785	ACAACTCTTCACACCTATACACCTCACTTCCTTTACCATTTACCAA
ps_bridge786	TACTTCTCCACAATTCTCTACCAAACCTTAACATACACACCTCCTA
ps_bridge787	TCTCTAAATCCAACTCACCTATTCACCTACCAACTACACTATCACC
ps_bridge788	CTCATCTTAACTACACATCTCTCACCTCTCTCATCATTCCATTCAC
ps_bridge789	TTCACTCCAACACACTACATCAAACCACCATATTCCATTTCTCTCT
ps_bridge790	CTCCTCACTTCCACTATCATAACTTTCCTCACTCTCTCCTATCATA
ps_bridge791	ACTCAAATCACACACCACAATTCCTTCTCCATCATTCACTCATCAA
ps_bridge792	ATTCCACAACACATCCACATATCACCATCTACATCTATTTCTCCAC
ps_bridge793	CTCATACCTCACCATTCCTACTATCCTAATTCCACCATTCAACCAT
ps_bridge794	CCATACTTCCACACAATCCATCCTATAACCTTCCTAACCTTAACCT
ps_bridge795	CTTATTCTCCACTTCTTACTCCTACAACCACCAATCAACTACCTAC
ps_bridge796	CCAACCAACAACACATCCACACTTTCCACTAAATACAACACTAATC
ps_bridge797	ACAATCTTCCTACATTACCTTACCACACTCTCTACCAATCCTACCA
ps_bridge798	ACCTCACTCTACCACATCACAATCTTCCATAACCACCAAATATAAT
ps_bridge799	ATTCCATCTAACACAATCACTAACTCAACACCTTTCTCCTCCTTCA
ps_bridge800	CTTCTCCTCTTAACTCATAACCAATTCACACTTCATCACAACCAAC
ps_bridge801	TATCTCCAAACTCATCCATCTCTTCCAAATCACCTATTCCATTCCT
ps_bridge802	TCTCAACACCATCAATTACTAATCTACACCACCTTTCTCTCCTCAA
ps_bridge803	CACTCCACATACTTCACCTCAACAATAAATACCACTTCACACTTCA
ps_bridge804	ACTTACACATCAACACAACCTTACTCATCCACATTAAACCTTCTCT
ps_bridge805	TACCTAACTCCATCCACTACCTACTAAACACCATACTCCATACTTT
ps_bridge806	ACTCTACAATCCAACAATCCACTTAACACCATCTCCTTTATACACA
ps_bridge807	CCTAAACCATCTACTACCAACAATACCTATAACCATCAACCACACC
ps_bridge808	ACCTATTCCTTCAACTCCTCTACAACACCACATTTAACTACTTCAA
ps_bridge809	CTCCTACTTCAACACCAAATCACAACACTAATACCACTCTCACAAT
ps_bridge810	TTCTTCTCCATATTCATCCTACCAATCCTCCATCTACCACACATTC
ps_bridge811	TCATCACCATCACCTTCCTTCAAACTATTCACAACAACTAAACAAC
ps_bridge812	TTCCTACCTTACATTAACCACCTTCCTTAAACACTCCTCTTATTCC
ps_bridge813	AAACATCCACATCCAATACACTTCCTTCCACATATCTACATACCAC
ps_bridge814	ACCTCACATCATATACCATTCACACATCACACCACATTACTACTTT
ps_bridge815	TTTACACTCCACATCTTCCATACCTACTCTCTTCACCATTCTCACA
ps_bridge816	TCATTTCAACTACTACTCCTTCACACTCCTCTACCATTCAATTCCT
ps_bridge817	CATCACTAAATACCACCTCACACCATTATCCTCACATATACCACAA
ps_bridge818	ATCAAATCCTTCAAACCTTCACAACCTCTCCTTCATCAACTTAATC
ps_bridge819	ACCAACATACACTAATTCTCCATCTCCAACCACCTAAATTTCTCAC
ps_bridge820	TCCTAACTTATACCACCTTCTTACATTTCTCTCTCTTCCTCCTCAT
ps_bridge821	CTCACTCATCCACTTACCTCACTTCATACCTATCTCAACACTTTCT
ps_bridge822	CCAACTCACAACAAATCCTAATTATACTTCACCTCCACTCTCCTTA
ps_bridge823	ACACACACAACCTTCAACCTACTCATTCCTCAATCCTACAACAACC
ps_bridge824	CATCTCACCAACTCTCAAATCAATTCCTCCACCAAATCACTCTACT
ps_bridge825	CACTACCTCTTCACACTCTAATCCACATCTTACCTCTCCTTCACAT
ps_bridge826	ACTCTTCAACACCAACCACAACCATCACTACATTACATCATCATTA
ps_bridge827	ACAATACTCACTCTCCAATTTCTCCTCTCACCAAACTTCAACATCC
ps_bridge828	CTCACATCCATCCTCTCATCTACATCCAATTCCATCTCTCTTTACA
ps_bridge829	ATCACCTCCATCAACTCTCACAACATTATACCTTTACAACAACCAA
ps_bridge830	ACCTATTCCTCACCTCATCTTCTCTTTATCCACTCCTTATCTACTC
ps_bridge831	ATAACCAACTAATATCCACTTTCTTCCACCTCACTCAACTCCACAC
ps_bridge832	AACCACTCACAATACAAACACAAATACCTCTAAACCATCTTCCATC
ps_bridge833	TCCACATCACCATACACCTCAATTCTCCTACAATCTATTACCAATC
ps_bridge834	CCTCCACTATCCATTCACATACCTTCAATCAACCTATCAACACTTC
ps_bridge835	ACACCTTACTCTTAACTACTACCTTATCTACACCTCCACTTCCACT
ps_bridge836	ATCCTCAACATTCCACACAACCAATCCATAACCACTTATCATCAAC
ps_bridge837	CCTTCTATCCATCTTCCTTCTCCTACTTTCATCCACTCACCAAACT
ps_bridge838	ATACTCAAACTCAACTCATACTCAACTCCTCACCAACTATTCCAAA
ps_bridge839	TCATCCTCTTCTTATCCTCTCACATACACAACAACTTTCCTCTCTC
ps_bridge840	TTCACAACTTACATTTCAAACCAACCAACCATTTCCAATCCATCAT
ps_bridge841	AAACCTCAACACATCCTCAACCTCACCAAATCTCACTAAACATTAT
ps_bridge842	AAACTTTACCATCCACTCCACCTTACTCATTTCTCTCCACACATCC
ps_bridge843	TCACTCACCAAACTTCACTCCTTTCACATACACACTTCCATCATTA
ps_bridge844	ACTTACCTATTTCACCTTTCCTCAAATTTCACACCTCCACAATTCA
ps_bridge845	TCCATTCACAAACATACCACACAACTCTATTCCACCAATCAATCAC
ps_bridge846	AAACTCAATAAACCATTACACCTCTTCCACACTAATCACCTCCATC
ps_bridge847	TCCAATCCACTTCTTACATTTCTTCTTTCAACTCATCAACACTCAC
ps_bridge848	AACACACACTATACACTCTCTACCATCCTCACACCTCTATAATCTC
ps_bridge849	CTCATCTCCACTACAAACACATTTCATCACAACTTATCCTACTCCA
ps_bridge850	CCAACATCTTCTACTCTCACCACTCCAACCATTACCTTCTCCTCTT
ps_bridge851	CCATATCTTACTCTCCAAACCATTCCTACCACCTCCTTACTTAAAC
ps_bridge852	ACTCCTATCAAATCCACATTCACTATCTTTCTTCAAACACCACCAC
ps_bridge853	CCACATTCACTCAACTATCATTTATTACAACTTCCTCCTCCTCTCA
ps_bridge854	CCACTCATCTAACTTCCTCTCACCTTCAATTCATATCATCTCCTCA
ps_bridge855	AACATCTACCTACCAAACACTAACACTCCACTACACTCCTCATCAA
ps_bridge856	ACTCACAACTCACACAATTCAACATTATTCCTTCACTCTCCACCAC
ps_bridge857	ATCCTCCACACTACACTAACTAACCATTTACATCCACCTTACTCTC
ps_bridge858	CATCACTAACCATACAAACATTCTCCACTCATCTCTCTTACACCTT
ps_bridge859	CTTTCTATATTCAATCTCCAACCACTCACCAATCACTCTCTTCTCA
ps_bridge860	CTACCAACCTACAAATCCTCAATTCCACTCCACATTTCTCACACTA
ps_bridge861	CTTCAACATACCATAACTCAATTTACTCCTCTTCCACCTTCCTCAT
ps_bridge862	CCTCTATCCAAATCCTACATAACCTCAACTCTCACTACACACTCAA
ps_bridge863	AACCACTCAAACTCTTTCTACCTTCTTCAAACCACAATTCTACACC
ps_bridge864	ACCTAACTACTTCATCTCTATCCATACAATCATCCACACTCCATCT
ps_bridge865	ACACACTTCCTCAATCCTTATCCTACCACTCATCCAATTATCCTTT
ps_bridge866	TTCCACCTATTCAACCACAATTACCAATTACAACCACCAACCATTT
ps_bridge867	CTCATCTCTCCTCACTCCATACCTTTCCTCAATACCACAATTATTT
ps_bridge868	CTAACCTCCTACCATACATACACTCATCTCCTAATATCCTCACCTC
ps_bridge869	TCTTCTTCCTCCATCTACCAACCATTCTAATATCATCCATTTCACC
ps_bridge870	TATCTCTCCACAAATTCACTCACTCACTATCAACCTCTCCTCTACT
ps_bridge871	AACACAACATTCATACCTCACCACTTCTTAACATCACACATACACT
ps_bridge872	ACTCTCACTCCATTCCTCTCTTCTTACACTCTCAAACTCACTTCTT
ps_bridge873	TAACATCTCCTTCACAACATCAATCAATACACCTCACACTAACCTC
ps_bridge874	ATCACACTTCACCTCCTAACAAACCACCATATTCCTCATTATAACA
ps_bridge875	CCACACTACACCAACCTCTTACAACAAACCTATCTACTCTTACATT
ps_bridge876	TACATCTACCAACACACACCACAATCCATACCTTAACACTCACTAT
ps_bridge877	CTCTCTACCACAAACAACACTTCCTATCAACACCAATACAACACAA
ps_bridge878	CAATTCATCATACTCACTTCTCTACTCTTCAAATCCATCCTCACCT
ps_bridge879	TAAACATCACTCTCACTAACACCTTTACATACCTCCATCTCACACA
ps_bridge880	TACCACTCCATTTCCTCCACTCACAATCCTAAACACACTTACTACT
ps_bridge881	CACATCCATACTCAATCAAACACAAATATTCTCCAAACTCTCCTCC
ps_bridge882	ACACCATTTATATACCACATCACCTCACATACCTCCTACTCTTCCT
ps_bridge883	CTCTACCAATTTACCACTTACATTATCCACCAATCCTTCCAACACA
ps_bridge884	CAATTTCTACAATACCACCACATCACTATACTCTCTCACCACCAAC
ps_bridge885	CTTCCTCATCCTACCTCATATTCTTCACTCCTCCTCCTATTTCAAC
ps_bridge886	CCACACTTCTCCTCTTCCTTTCCTTCCTTTCAATATTTCACCATAA
ps_bridge887	TCAATTTCCACTCACACAAATTCAACACTACATTATCCACTCACAA
ps_bridge888	TCCACTCTCACATACTCACCTTAATTACAACACCTTCCATTCTCCA
ps_bridge889	TCACTACTTCCTTACACATTAAACAACCATCTTACTTCACACACCT
ps_bridge890	CACATATCAACATCTCTTCATATTACTCTCCATACCACCTCCATCC
ps_bridge891	ACAATTCTTAACATCAAACACCTTAACACCATCCTTACCTCTCTCC
ps_bridge892	CTCACTACACCAACAACAATCCAATTCCTTTCACATCTCTTCACAT
ps_bridge893	ATCACTCACCAAACCAACAAATACCTTTCATACCACATTCCTCCAT
ps_bridge894	CCACTACACTAATACATTTATCCTCTCTCCTCTCTACAACCTCACT
ps_bridge895	AACTCTCATACACTTCAACTAACCATCCACTTTACATCCATCATCC
ps_bridge896	TCTTCTCACTTCAATTCACATTCTCCATACACTCTTACTCCATTCC
ps_bridge897	CACCATCTAACATAACATAACCTTTCACACTCTCATCCTCCTCCAA
ps_bridge898	CACACCTTAAATTCACATCAACACTCTCCAACTTCTTCTTCAACCT
ps_bridge899	TCTATTTCCTCTACTCCTTATCACAATCACATCCTTCCACAATCCT
ps_bridge900	TCACAAACTCCATTCTACACAAACCAATTACATCACACCTACTCTC
ps_bridge901	TCACTTCATACCTTTCCACTCATCAACACTCTCTAACTCCTACACC
ps_bridge902	CACACTACTCTACCACACTTTCCACCATTAAACAATCTCTTACTCC
ps_bridge903	TACTCTTCCTTCCACTTCTCATACAAACACACCTTCAATTTCCACA
ps_bridge904	ACTCCTCCATCACCTTATCACATCACACTCTTATCCACTCTCTCTT
ps_bridge905	ACCTCTTTCCAACACTCTCTTCCTTACATACTTCACTTCTAACCAA
ps_bridge906	CATCCACCTCAATTACCTAAACTCATTCTCTCACATTCTTCCTTCA
ps_bridge907	CACATCCAAATTACCACAAACTCACCTCTATTACACTCCACATACA
ps_bridge908	CCACTAAACTACACTTCCTTAACTCACATTCCACATCACTTTCCTC
ps_bridge909	TCATCTCATCTCTCACAACTAACCTCTCTCAACCAATCTACTCTTA
ps_bridge910	CCACACTCCTACCTTTCATCCATTCACCATTAACCTCATCAAATAT
ps_bridge911	TCTCAACCACTTCACCTACAAACTAAACTAACCATCCAATCCTAAC
ps_bridge912	TCACACCATTCTTATTTCCTTCCTACTCACCACTACCTCTTCACTT
ps_bridge913	TTCTCCTACTCCATTCTACCACCACCTATTCACTCTACACATCAAT
ps_bridge914	ACACCATTTCACATAACTCACTACTCTCCATTCAATAACATCCACA
ps_bridge915	CCAACCATCAAACCACTAATCAACACTCTCCTCACTATCATTCTCT
ps_bridge916	CCAATCTATTCAACCTACACATTCACTCAACCTTTCAAACTCCATT
ps_bridge917	AACATAACATCTCATCCACTCTCTAACTCAAACTCCACTAAACCAA
ps_bridge918	CATTTCAATCACTTCACACCTTTCCATCCAACCACAACATCAAACC
ps_bridge919	ACCATCACTCCATTCCTCCTTACTCACTCTAACATCAATTCTTCTC
ps_bridge920	TCACCTTCCATATATCTCCATTTCTAATTCTCAACCACTTACCACC
ps_bridge921	CACCTATTCCACAAACCAATACATTATCCACTTTACTTCCAACCAA
ps_bridge922	ATACCTCTTTCCTATTTCCTCAACACAACTCCTTACTCAAACACAT
ps_bridge923	CAACAAACTCCTTTCTTCCTCCATCCTACTTATCTAACTCCTCAAA
ps_bridge924	AATCTCCAACCACATATCCTAAATCACCTTCACCACAACAATCTTA
ps_bridge925	CCAATTACTCTCCAAACACTACCAAACTCTACTCCTCAAACAAACC
ps_bridge926	TCATACTCCTTATTCTTTCACCTCCTACACTCAATCCACATCCTTT
ps_bridge927	CACCACAAATTTCATCCAATTTACCTCACCAATCAACACTTCTTCC
ps_bridge928	CCACTTTCGATACTTAACTCCTCAAACATCCTCTCTACTTCTCCTT
ps_bridge929	ATCATCTATCTTAAACCACTCCTCATCTTCCTCCACCTCTACATTT
ps_bridge930	CCTTTCATTCACAAATACTTTCCTCACTCTAATCCACCTCTCTCTC
ps_bridge931	TTTCACTACATCCATCCTACATAACCTATCCAAACACCAACATCTC
ps_bridge932	AAATCACCACATCTTTCTCTCCATCTCATCTAATCTCTCTCAACAC
ps_bridge933	ACAACTCTTCTTCAATACCAATCTCTCCTTACATCACAACCTCACC
ps_bridge934	ACTCCATCTCTACTCACAACTCATCACTATACCAACCTCTCTCTCC
ps_bridge935	TTCCACATCTCCATATACACCAAATCTCACTATTTCCTCCTACCTA
ps_bridge936	TTAACCACCAATTACATTCCTCAACTCCACTAACTAAACAAACCAC
ps_bridge937	CCTTACACACTCCTATACAACCACTACCACATACCATCCTCCTTAT
ps_bridge938	ACACCAATATCTCCTCTCTCCTTCCTCCTCATCTAAATTTACCATA
ps_bridge939	TCTCTAACTCTTACCAAACTTCACTACAATCACCAACTCCTCACAA
ps_bridge940	CATCCACCTCAATTAATTTCCACACCTCTCATTAACCTTCTACACA
ps_bridge941	TACACTACTCCATCCTACACACCTTCAACCAACTAATACTTCATCA
ps_bridge942	ACACTACTTACCTCATACTCCTATCCTAACACAAACACACACTCAT
ps_bridge943	TCACCTCAATATCCAACACTATCTTACCTACCACACTCACTTTCAT
ps_bridge944	TTCCTCCTCTTCCTCACCATTACACACTCAATAACACACATCACTC
ps_bridge945	ATTCATTTACAAACTAACCTCCTTCTTCCTCCTTCCACCAAATCAC
ps_bridge946	CCAATCTCTCCACCTAAATCTAACTCTTCCACAATTACACACCAAC
ps_bridge947	TACCTTCCACCTTACACCAACTCCATTACAACTTCATTTCAAACTT
ps_bridge948	CAAACATTTATCCTCTTAACACTCCACCTACTCACAACCTACCACC
ps_bridge949	TCTCTCAATTACCTTTCTTCCTCTCACCATTCACATCTCTCACATC
ps_bridge950	ATCTTCTACAAACATCTCAAACTACTTCTCTTCCTCATCTCACCAC
ps_bridge951	ACCACCTAACTCTTTCCTTTCTCCTACCATACCATCCAAATCCACA
ps_bridge952	CAACTAACCTCTCAATTTCCATTTACTACCATCTCCTCCTCCATCA
ps_bridge953	ATAACAAATCTAAACTCACAACCTTCCTACACCAACCTTACCACCT
ps_bridge954	CCTCATATCTACTAATCCACTTTCTCCTAATCACCACCAACTCACA
ps_bridge955	TCTACAACCTCATCTACACTACTATACTCTCCTCTATCCACACACC
ps_bridge956	TCCTCTACAAACACCACATTAACAACAACCATCTTCCAATCCACAC
ps_bridge957	TTACCACCTCTCCAACATAATTCTCATCAAATCCTTTCTCTTCACC
ps_bridge958	CAACTCCTTTCTCTCTCAACACACACCAAATTACTACACCTTCAAA
ps_bridge959	CACACCATTCTCCTATTCCAAACAATACATCATTTCCACCAACATT
ps_bridge960	TCTCATCCTCACATCACACCTCTATCCATTATCAACCACTCTTTAT
ps_bridge961	ACTTCAACCTCCTAACTTCTTACCAACATCCTTCCTTCTCCACATT
ps_bridge962	ACCATAACTCCTTACCAACAATATCCAACCTTTCCATCACTTACAA
ps_bridge963	TAACTATTCCTTACCAATCACCACATCCTTAACTACACCTCCTACA
ps_bridge964	CCAATCTCCAACCATATAAACAAACATTCTACTCACCTTTACCACC
ps_bridge965	CACTCATTATTTCACAACACCTTAAACCTCTTCTCACCTCTCTTCC
ps_bridge966	ATTCCATCTCCAACCATTACTTACATACACCATCACTCCAACACTT
ps_bridge967	CAACACCAAACTTTCTCACATATCTATATCCTCCTTTCTCCTTCCA
ps_bridge968	TAAACTATTAAACTTCAACATTTCACTCAACCACCATCTCACCACC
ps_bridge969	CTTCACATATTACACTACATCCTCCACAATCCTCCACCACAAACTA
ps_bridge970	CACTCCATTCACCAAACAACTATAACACTTTCCTACTTCTTCCACT
ps_bridge971	CACACTCCAATACACTACTAACCACAACTTCTACCTAACATCCAAA
ps_bridge972	TCCATCCTCCTCTCTTACCTTATTTACACAAACTCAACTTACCTCC
ps_bridge973	ACCTTTCCTCACACTACTCAATAACCAACCTCTAACTACACCTAAC
ps_bridge974	AATCCTCACCACTCAATTCCAAACTCACACACACCATTCAATCTAC
ps_bridge975	ACACATTCCAACAACATAAACTCACTCTCTACTTTCCTCCTTTCCT
ps_bridge976	CTTCCATACTCAACAACAATACATTTCCTTCCTTCCTCACTCACTT
ps_bridge977	TAACCTTACTCCTCCTAAACTACCAAATCAATCTCCACTCCTACCA
ps_bridge978	ACCTCACTCATCACACTTACTCTAATCTCCATCCACCATAATCAAA
ps_bridge979	AACCTACCTATACAACACCAACTCTTTCTTCCTCAACTCATCCACT
ps_bridge980	ACCACACCTCCAAATCATAAATTCAATAACATCCTTTCCAACACTT
ps_bridge981	ATTTCCATAACCTCCAATCTCCACATACTCAAATCATCCTTCTTCT
ps_bridge982	TTCTCCACCATACCTTTACCTTCTTATCTCCATCCTTACCACCAAC
ps_bridge983	TCCAAACCACTCTTTCAATTACATCCTCCAAACACTTACCATCTCT
ps_bridge984	ACCACCTTTCTCTCATAATTCCAACTTACTCCACAACACTCATTAC
ps_bridge985	ACACCAACTCTCCTCCTATCCACACTTAAATATACCATCCACAATT
ps_bridge986	TACTCCTACATACTTTCTTCAACCTTTCCAATCCATTCCAACTACA
ps_bridge987	TACCATTCACACCTACATCACTCTTTCCATTTCCTTCAACTATTCA
ps_bridge988	CACACCTACACTTTCCTTCTCTAACATATCTATCACCACACATCAC
ps_bridge989	TCTCCAACCTTTAATCCATTCAATTCATCCACTACCACCTACTACA
ps_bridge990	TCCTCACCTTAACTCACTCCTCCAATCATTCCATCATCAACAAATA
ps_bridge991	CCACATACCTTCTTTCTTATCATCTTCTCAAACACACCTCTACTCC
ps_bridge992	CATAAACTCCTCAATCCTACATTCCACAAACTTTCTCCATCACCAA
ps_bridge993	CTCTTACTCCACTACTCCACCTCACACAACTCATTTATTACAACTT
ps_bridge994	TCACCTTCACAATTACAACCTAATCACCTCCTAATCCATTTATCCT
ps_bridge995	TCATAACAATCCACACCATTCTCTCTCCAACTTTCACCATTTATCT
ps_bridge996	CCTTCCACACCATCTCTCCTCACTATAACTATTTAACCACAATCTC
ps_bridge997	TCCAAACACCATCCTCTATCATTCCAATCTTTCCTACATACCTCTA
ps_bridge998	CCTACCAATAAACTCCTCCTTTCCTCACTCTCATCCACATACATCA
ps_bridge999	CTTCACCATAACCTCTAAACCTCATTCCAACCATTCCTACATTCCA
ps_bridge1000	ACATCACTTTACATACCACACCTTCATACCTTCTCTCTACAACCTC
ps_bridge1001	TAACCTTTCATACCTAATCATCCACCTACCTTACTACACCTCTTCT
ps_bridge1002	CACTAACCAATTCCTTCCACAATCTCCACCTTCATCTTTCTAATCC
ps_bridge1003	CTTCACTCACTCATCCTTTACCACTTCTCACCATCTTATCCTAACC
ps_bridge1004	ATCTCATACCAAATCTCACACTCTCTCACTCTTACACACTCCTACC
ps_bridge1005	CCATTCCTCACCATCATACACACTAACTCCATTCATCACTCTCCTT
ps_bridge1006	ATTACACTATACACTTCCATCTCCTCACATACATAACACAACCACC
ps_bridge1007	ACCAATATTCCACTTCACTCAATTCTCTACCTATCCAACCACAAAT
ps_bridge1008	ATATACAATTCCTCCTCTCTTCCATATCACACCAAACCATCACTTC
ps_bridge1009	CTTTCTATTCACTCCTATCTAACCAACCTTCCTATTCCACACCATC
ps_bridge1010	TCCATCCACCTACAACCTAACTCTCATTTCTCCTCACAACATACCA
ps_bridge1011	ATTCTCCACTTCCTACCTACTTCTCCTCCAATTCAACAAATACACA
ps_bridge1012	AACCACAAATCTAATCTTCTATTCCACATCCATAAACTCTCCACCT
ps_bridge1013	CTCAACTCTCTCTAAACTCATAAACTACTCCAACCACACTTCATCC
ps_bridge1014	ATCTCCACCTTCTCCACCAATTTCATCTCTTCTACCTCTCTTCACC
ps_bridge1015	TCCACTCATAACCTACCACAATACCTTACATCCACATATTCTACCT
ps_bridge1016	AACCTTCCTTTCTATCCTTCCAATCCTCAAACACTAACCTAAATCC
ps_bridge1017	TACTACATTTCCTAACACACAATACCAACTACTTTCCACCAACCAA
ps_bridge1018	ACATCACATCTCTCCTTACAACCATAACCTCCATCAACCTCTCCAT
ps_bridge1019	AACCTCACCTCACCATTCTATCTTCATCTACCACTTCTCTTATTCT
ps_bridge1020	CCTCAACCAACCATAACCATTCATCTCATCCAACTCCAAACCACTC
ps_bridge1021	CCTTAACCAACTTAACCACTAATCCTCACACCACAACTTTCATCAA
ps_bridge1022	TTTAACCACTCACTTTCTACACCAACAATCAACTTCAACACACTAC
ps_bridge1023	TCTCACAAATCACTTCACTCACCATAACCAAACACTCTTACCTTCA
ps_bridge1024	ACTCACCATTTCTTCTCAACCTTATACATATTCCACAACTCCTACC
ps_bridge1025	ATATATCTCTTCACCTCTCCACCAAATATTACACATCCACACCAAA
ps_bridge1026	CTCACTACCACACAACTTTCACTCCTCACTTCACTTCCACCATACT
ps_bridge1027	TTCACTCCTATTCAATCACCATTACATTCACCATCCAAATTCCTCT
ps_bridge1028	AACACATTCAACCACATAACTTAAACATCACTCCATCAACCAAACC
ps_bridge1029	CCATCCACCATCTATCTACAACCTAATACCAAACTCATATCCTTCC
ps_bridge1030	CACCAAATTATCTTCATCACCACATATCTCACACTTTCTCACCAAC
ps_bridge1031	TCACCTTCTCACTCCTTCATCTCTAACTCCTCTAATACTTCAAACT
ps_bridge1032	ACATCATCCAATCCTACACTTCACTCTCCTTTCTTCAACATTCTTC
ps_bridge1033	ACCACCAACTCTCAAACACACTCTCACTTCATACATACCTCTTACA
ps_bridge1034	CCACCTCACATCAACTCACATTACCATCCATCACTTCTACAACAAC
ps_bridge1035	TTCATCCACCACATACCTAAACCAATCAACAAATCCTCTATAACCT
ps_bridge1036	TTCCTACTCAACATCCTCACAACACTTCATCCACATATTCCTCTAT
ps_bridge1037	CTACAACCTTCCTACTTTCTTCTCCAATCCACACAATAACAACCAA
ps_bridge1038	AACATACCACTCAACACAATTACATCATACTCCACATCCATACACT
ps_bridge1039	CTCCAATATACTAAACCTCAACCACTTTCCACTATCACACCAACTT
ps_bridge1040	AACAACCTCACTTACCACAAACTCAAATCTTATCTACACCACCATC
ps_bridge1041	ACCTTACACTATACAATTCACCAACCATCCTCTCCTATCACTTACT
ps_bridge1042	CTTCAATCCTTTAAATCCACATTCAACCACTACAACATCTCCTCCA
ps_bridge1043	CTCCATCCACTCTTTATTCAACCTTCCAATTTATTCCACTCACCAA
ps_bridge1044	TTCTCACTCCATCCTCATTTCCTCATATCTACACTATCCTACCTCA
ps_bridge1045	ACCACATTCAACAATTCTCCACACAACTTCTTACCTCTCTATCATA
ps_bridge1046	TCCACTCTATTCTCAACATTTCATTTAACTCACTCATTCCACCACT
ps_bridge1047	ACTCTCATCCTCTCTCCACAAACACAAACTTCTTTATTTCCACTCT
ps_bridge1048	CATCACTCTCATCATTCCTCAATTTCCACTTACTTCCTACCACTCC
ps_bridge1049	TTCTTATCACTCCATACAACCATTCTTCTTCCATACACTCCAACAC
ps_bridge1050	ACTCACAAACCTTCACACTAACTATACACCACTCTCTTCCTTAACC
ps_bridge1051	ATCCACCATAACTCTATCAAATTCCTCTCCTCACTAACCATACCAA
ps_bridge1052	CTTCTCAACTCTTCCTACCTCACCTCATCACAATCCATCCTTATTA
ps_bridge1053	CTCAAATCTCCAAACTCCATTCCTTATTTCACTCCAACTCTCAACT
ps_bridge1054	TACCACAACATAACTAAATCCACTCTCTCATATCCACCTTTCCTTC
ps_bridge1055	CCAACACACCACTACTCCAATACATAACCATTAACCTACTCCAAAC
ps_bridge1056	AATCCATTCCTACACCACCAACCAAACACATTACCTTATTCATCTA
ps_bridge1057	TATACATATCATACCAACCTTTCCACTACCTCAACCACTTCCACAC
ps_bridge1058	AATAACCTTAAACCACTACTTCACTCTCACACACTATCACTCCTCT
ps_bridge1059	ACTCAACTCCATCTCATATCATCCACCTAAACATACATCAATCTCC
ps_bridge1060	ACTTCAACTCAATACTCCTCCTTCCACACAACACCTTACTCATATA
ps_bridge1061	TACCTCTTTCCTCTTACTCATCATTACCTTCTCCAATCACTCTCCA
ps_bridge1062	TTCCTCTTCATCATCTACTTCTTCCTCTCCACTTACTTCCACATAA
ps_bridge1063	TTCCACCTACTACCATATACTCTATCCTCTCTTACTAACCACTCCA
ps_bridge1064	CTCTCACAACTATCCTAAATTCCTCTCTACCTATCAACACAACCAC
ps_bridge1065	AACACATCACATTACCACCAAACTCATACTCCATTACCTCCACCTA
